「よ、よせ馬鹿者！」	「停、停下你个蠢货！」
「紛い物とはいえ、痛いものは痛いんだぞ！」	「虽然是纷扰的外物、但该痛的东西还是会痛的！」
「初物か……ふふ、案ずるな」	「是第一次啊……呵呵，不要担心」
「痛いのは初めだけだ！」	「只有最开始的时候会痛一下而已！」
「うぅぅ、やめろ……やめろぉ！」	「呜呜呜、停下……停下来啊！」
「頼む……やめて、くれ……」	「拜托……请停下来……」
「ぐうぅぅッ！」	「咕呜呜呜！」
「頼む、正気に戻ってくれぇ！」	「拜托、快点恢复清醒吧！」
「ふふふ、諦めろ……」	「呼嘿嘿，放弃吧……」
「お前はもう、私のものだ	「你已经、是我的所有物了
「はぁ～～はひぃ」	「哈啊～～哈咿」
「もう、辛抱たまらん！」	「已经、无法再忍耐了！」
「イタタッ……ばか者が！目を覚ますんだよ！」	「疼疼……你这蠢货！赶紧清醒过来！」
「う、あ…生娘……私は何を……すまない！瘴気にあてられた！」	「呃、啊…处女……我做了什么……抱歉！我被瘴气控制了！」
「ばかものが！目を覚ますんだよ！」	「蠢货！赶紧清醒过来！」
「……ここを出たなら、いつでも相手してあげるから……」	「……如果能离开这里的话、我会随时都陪伴在你身边……」
「……私は何を……」	「……我究竟做了什么……」
「すまない！瘴気にあてられた！」	「抱歉！我被瘴气影响了！」
「…ちッ！……本物の“おぼこ”を取られたのは、幾百年前だったかねぇ……」	「…嘁！……真正的“贞洁”被夺走、那都是几百年前的事情了呢……」
「はぁ…あははァッ！観念するんだよ！」	「哈……哈哈哈！还是乖乖投降更好哟！」
「…抵抗したら、それだけ苦しいだけだぞ？	「…要是抵抗的话、会吃苦头的哟？
まぁ、それはそれで、嫌いじゃないけどねぇ……」	嘛、不过那样不错、我并不讨厌就是了……」
「まったく…ここに居ては坊主も邪淫になるわ」	「真是的……在这里待着连和尚都会变成淫邪呢」
某坊主『ヘックしゅんっ！』	某个坊主『哈啾！』
「っぐぁ……つっ……っうぅ！」	「唔咕咕呜……呜唔！」
「だめ…だ……」	「不行……不行啊……」
「くっくっくっ！、どうだぁ、痛かろう？」	「哈哈哈哈！怎么样，疼吗？」
「案ずるな	「放心吧
すぐ気持ちよくしてやる	马上就让你舒服起来
「ひっ！うぐぅぅっ！…くそぅ！」	「咿！唔咕呜呜！…该死！」
「わかった！わかったから、もっと優しくしてくれ！」	「知道了！知道了啦、所以再温柔一点！」
「ほほぅ	「嚯嗯
中々の名器じゃあないかぁ	真是个名器不是嘛
「可愛がってやるぞぉ	「我会好好疼爱你哦
このオンバシラで、たぁっぷりとなぁ	用我的这根御柱、充分地
「ひいぃぃいぃんっ	「咿噫噫噫噫啊啊
らめっ	不行
それ触っちゃらめええぇぇ	那个地方不能碰啊啊啊啊啊啊
「聞分けのない不信仰者め	「真是听不懂话的不信者
「そんなに仕置きが欲しいか	「你就这么想要被惩罚吗
？　ほら、こうやって服を触れば	？ 看、这样一点点的触摸这衣服
「ひぐぅっ	「去了哦哦
らめぇ	不要
「イッた…ばかりなのにぃ	「刚刚……刚刚才高潮过
触手服に何度もイかされ、息も絶え絶えになって抵抗すら出来なくなった%CALLNAME:(TARGET)%を改めて襲い始めた	被触手服不知道多少次玩弄到了高潮、连呼吸都已经十分困难、无法再进行任何反抗的%CALLNAME:(TARGET)%、又一次的开始被触手袭击
「はははっ！そんなに触手がよかったか	「哈哈哈！原来你这么喜欢触手啊
「好き者め	「还真是好色呢
次は私のオンバシラだ	接下来轮到我的御柱了
こいつは半端ではないぞ	这可不是半吊子的水准哦
もう、らめぇ	已经、不行了
触手服に何度もイかされ、息も絶え絶えになって抵抗すら出来なくなった%CALLNAME:(TARGET)%を改めて襲い始めた。	被触手服不知道多少次玩弄到了高潮、连呼吸都已经十分困难、无法再进行任何反抗的%CALLNAME:(TARGET)%、又一次的开始被触手袭击。
？好き者め」	？真是好色呢」
「次は私のオンバシラだ	「接下里轮到我的御柱了哟
たっぷり楽しませておくれ	让我们好好享受一番吧
「よ、よせ！何をするか！」	「停、停手！你要干什么！」
「はははっ	「哈哈哈
ほら、さっさと生まれたママの姿におなり	看、回到刚离开母亲时的模样了呢
「よせ、やめろっ……やめろぉっ！」	「停下、快住手……住手啊！」
「はぁ～～っ	「哈啊～～
その絶望に染まった表情、ゾクゾクするねぇ	这种被绝望浸染的表情、还真是让人兴奋呢
「うぅぅっ、やめろ……やめてくれっ」	「呜唔唔、住手……拜托住手啊」
「くくくっ	「呵呵呵
普段の服より、その方が似合っているぞ	比起平常的衣服、这个更合适你呢
「そんな格好で誘ってぇ	「用这样的打扮来勾引我
本当は期待していたのだろう？」	其实你是在期待着的对吧？」
「うぅぅ…好きにするが良い……」	「呃啊啊……随你喜欢吧……」
「ふふっ…、ようやく大人しくなったか	「呵呵…、终于安静下来了吗？
「それでは、続きを楽しませてもらおうねぇ	「那么、让我们继续享受下去吧
「良い心がけです	「保持好心态
常に私のオンバシラを信仰していなさい	可以始终信仰我的御柱呐
「ひぎゃぁあぃいぃっ痛いいぃ	「咿啊啊啊咿噫噫疼疼疼。
いたいぃ……のが	明明好疼……
気持ちいいのぉぉぉおぉっっ	好舒服啊啊啊啊啊啊啊
「んひぃぃぃぃぃぃぃッッ	「嗯嗯咿噫噫噫噫噫噫
「はあッ、はぁッ…初物のくせに、随分と感じていたじゃない	「哈哈、哈哈啊…明明是第一次、却感觉意外地舒服不是吗？
どうしようもないドＭだねぇ	真是个无可救药的抖M呢
「イくっ、イくぅぅっ	「去了、去了
イっちゃぅぅぅっ	高潮了啊啊
「あぁぁ	「啊啊啊
中にっザーメンりゃめぇええぇ	不行、内射不行啊啊啊啊啊
「ふひぃっ	「呼咿~
このマンコすごっ	这个小穴还真是厉害呢
ミミズ千匹ぃぃ	像是有一千只蚯蚓在蠕动一样哦
「ぎひぃっ！！いいぎいいッッ！！」	「咿噫噫噫！！好棒、好棒啊啊！！」
(ううぅっっ！割れ目が焼けるようだ！)	（唔呜呜呜——！小穴就好像在烧一样！）
「ひぎょ	「咿齁哦
？！　ほおぉおごぉ～～～っ	？！齁哦哦哦哦齁哦～～～
～～～～っ	～～～～っ
(初物のクセに！なんて締め付けだよ！)	（虽然是第一次！但这种紧缩的感觉是怎么回事！）
「へえあぁぃいっ	「嗬呃呃啊啊啊咿噫
あひぃぃぃぃっ	啊咿噫噫噫噫
(あへあぁおおオマンコかってにビクビクしちゃぅぅ)	（啊啊啊小穴忍不住就抽搐起来了唔哦哦哦哦）
(絞り…取られるっ！)2830, 2)	（要被…榨出来了！）2830, 2)
「ぁぁぁ…	「啊啊啊…
なかにぃ	里面
「膣内射精しゃれちゃったぁ…	「竟然直接内射了…
「ふぅ…はぁ	「呼…哈啊
処女マンコは何度ヤっても…	处女的小穴不管怎么用…
最高に気持ちイよねぇ…	感觉都是最舒服的呢…
「へひぃぃ	「嗬呼咿
このマンコきもいいよぉぉ	这个小穴好舒服呢
クセになりそうだよぉ	好像会上瘾哟
「外にぃ	「外面
せめて外にぃぃぎぃいぃっ	至少往外面咿噫噫噫
「私は神様だからねぇ	「因为我可是神明啊
中出しだけは簡便してあげましょう	中出就简单恩赐给你吧
「んひぃぃいぃ	「嗯咿噫噫噫
うごかにゃいれえぇ	动不了啊
マンコこしゅれてぇ	小穴好有感觉
しゅぐいイっちゃううぅぅ	腻害的高潮要来了哦哦哦哦
「ふひぃぃぃ	「呼唏噫
ミミズ千匹しゅごぃぃぃ…	像是千条蚯蚓蠕动一样、真厉害…
おんばひら射精でりゅっ	御柱马上要射精了
外に神の粥出して	神之粥要射出来了
粥漬けにしちゃうのぉぉ	把你浸泡在神之粥里哦哦
「あぎぃい～～っ	「啊咿噫噫噫～～
「んぎいぃ～～っ	「嗯咿噫噫～～
(どうして…痛いのに……痛いのにぃ～ッ！)	(为什么…明明很痛……明明很痛但是！)
「へえあぁぁっ	「嗬呃呃啊啊啊啊
あひぃぃいぁあぁぁっ	啊哈咿噫噫噫啊啊啊啊
「ほひぃぃぃっ	「喔喔喔喔喔
くりゅぅう	来惹哦哦
おんばひらアクメくりゅぅぅっ	御柱高潮来惹呃唔哦哦哦
「うっ、くあっ……にがっ」	「唔、唔咕……好苦」
「ふぅっ、はぁ…	「呼、哈…
あぁ～気持ちよかった…次は中にさせて欲しいねぇ	啊～好舒服啊…下次想要在你的里面哦
「へえあぁ	「嗬呃呃啊啊
あひぃぃ	啊咿噫噫
「な、中、いっぱい、出されて…」	「里、里面、被灌得满满的…」
「う、あ…中に…」	「呜、啊…里面…」
「うぁ……、どろって……」	「唔啊……、黏黏的……」
「う、くっ…！」	「呃、咕…！」
「何故、仲間からこんな仕打ちを…！」	「为什么、会从同伴那里受到这样的对待…！」
「ふぅ～～スッキリした	「呼啊～～真是舒畅
またやろうねっ	我们再来一次吧
「あぁ……	「啊啊……
も…犯さにゃいでぇ	不要…再侵犯我了
ひぃぃうぅっ……」	咿噫噫呜呜……」
「ひぃいっ！や、もういやあぁぁああ！」	「咿噫啊啊啊！不要了、我真的不要了啊啊啊啊！」
「よーし、もう一発いこうかぁ	「好、我们再来一发吧
ふふふっ、満足するまで付き合ってもらうぞ	哈哈哈，要一直陪到我满意为止哦
「第二ラウンド開始～～ッ	「第二轮开始～～
「よせぇ！もう、やめてぇっ！」	「停手！已经、快住手啊！」
「ああぁ～～おんばひらビンビンッってぇ	「啊啊啊～～御柱在一跳一跳的
「もう、元に戻れないよぉぉ	「已经、没办法回头了啊啊
「ひぃいっ……あひぃぃ	「咿噫噫……啊咿
にんっしんっ！…かくじつぅ……	妊娠！…确定……
「…うぅ…ぁ、が……」	「…呜呜…啊、呃……」
「うぐぐぅっ！いい加減にしろ！ばか者が！」	「唔咕咕呜！给我差不多一点！你这蠢货！」
「このっ！いい加減にしろ！ばかものが！」	「可恶！给我差不多一点！你这蠢货！」
「うああぁ、やめ！…もうやめてぇ！！」	「呜啊啊啊啊、不要！…快住手啊！！」
「っはひぃ…	「呃啊咿…
処女マンコいいよぉぉ	处女的小穴好棒啊啊
「とまんにゃいっ！オンバシラレイプとまんにゃいょぉぉお…	「停不下来！御柱强奸停不下来哦哦哦哦…
「ひいいぃぃああっ！もうやだぁ！」	「嗬咿噫噫噫噫啊啊！我不要了啊啊！」
「ひぐぅうあああひぃぃ	「去惹呜哦哦啊啊啊啊啊噫
痛いの気持ちよくにゃってるよぉぉ	痛的感觉变得好舒服哦齁齁哦哦哦
「はあぁぁあ	「哈啊啊啊
処女レイプ癖になっちゃったぁあ	变成处女强奸癖了啊啊啊啊
「んんぁあっ	「嗯嗯啊啊啊
ああっあぁあんんっ	啊啊啊呜啊嗯嗯
「も、やめぇっ	「停、停下
やめてええぇぇっ	快住手啊啊啊啊
「オンバシラレイプ気持ちいよぉぉ	「御柱强奸太舒服了哦哦哦
もっとぉ、神の粥どぴゅどぴゅしゅるにょぉぉ	更多、神之粥更多更多的射出来哦哦哦
