東方触手宮　神奈子口上	东方触手宫 神奈子口中
淫乱聖口上ベースにしたというか	以淫乱圣口为基础
淫語の多くが聖んと被ってます。	淫语中有很多和圣的重合。
あとテキスト表現ルナティック以上の口上もあるので注意。	还有一些超乎日常表达的句子，所以请注意。。
「ひぅっ	「唔
ひっちゃうぅ	要去了
かにゃこっ	神奈子啊啊啊
まらイきゅぅぅぅっ	又要去惹
「っっっっっぁ	「啊啊啊啊啊
「んほおぉ～	「唔哦哦哦哦～
「～～～っ	「～～～哦
あ～～～～～	啊～～～～～
「んあぁあッ！	「唔哦哦！
かにゃこぉぉおぉっオナバカになっちゃぁったのぉぉ！	神奈子啊啊要变成自慰白痴了啊啊！
「とまんにゃいぃぃ！	「停不下来啊啊！
おにゃにぃイグのぉぉ！とまんらいのぉぉおっ	又要去惹，又要去惹!停不下来哦哦哦
「イっひゃうっ	「哈啊哈啊
らめ	不行
らめなのにっ	虽然不行
手が	但是手
とまらにゃっ	完全停不下来
「からだぁ	「身体
疼ッ！んあ゛あぁぃッッ！	好疼，好热！想要！
「がまん	「要忍耐
れきにゃいぃっ！	不能放弃哦哦！
「ゆっ	「手
ゆびがっ	手
とまらにゃ	停不下来
んん～～～っ	噢噢噢噢～～～っ
「ふあぁっ	「哈啊
ひゃぁっ	唔啊
きもひっ	感觉
よくれぇぇっ	好棒
「ら	「不
らめぇ	不行
からだっ	身体
あつくれぇっ	好热啊
「ゆ、指が、止まらな……	「手、手指、停不下来......
「クはァッ！……も…やめ……」	「唔啊！……不…不行了……
「あぐぅッッ……やめて…もう、戦えないからぁッ！」	「唔啊啊……快住手…不要、已经不能再战斗了！」
「あひゅぅぅぐぅ！……らめっ！……痛いのときもひいの一緒らめぇ！」	「哎呀呀呀疼疼！......不要啦！......痛的时候就别靠近了呜！」
「えぐぉア゛ハァッ――！！」	「哇啊啊啊啊！！」
強烈な一撃によって急所を抉られた神奈子は苦痛に耐え切れず	神奈子因为被一记强烈的攻击击中要害而难以忍受痛苦。
その場に膝を付いて悶える事しかできない。	只能跪倒在地痛苦的蜷曲呻吟着。
「ひぐぉあぁあッ！！……あ、がっ……」	「哇啊啊啊！！...啊，呕...」
猛烈な苦痛が、一撃で神奈子を沈める。	猛烈的痛苦、只用一击就击沉了神奈子。
さしもの軍神も到底耐える事はできず、床に転がりながら血の混じった胃液を吐き散らしている。	即使是传说的军神也无法忍耐，只能在地上痛苦的翻滚着，呕吐出混着血液的胃液。
「っかふ、ぁ……」	「呃、唔啊......」
「こふっ、ぐぅぅっ！」	「唔呜呜呜！」
「まだだ！」	「还没完！」
「ぐっ！」	「唔！」
「イぅッッ	「唔
イっひゃぅうぅッ	哈唔
へえアアアァアッッ	呃啊啊啊啊啊
「ちょうらい	「拜托
もっとエッチちょうらいぃいっ	拜托让我变得更下流些吧
「もっろぉっ	「更多
もっろイかせて、ぶっ壊れるまでぇっ	还要更多的高潮，让我的脑子彻底坏掉吧
「っっっあ～～～～～	「哦～～～～～
あ゛～～～～～	啊～～～～～
「やあぁあらめえぇっ	「不要啊啊啊
かにゃこぉっ	神奈子又要去惹
こんにゃの我慢れきないのぉぉっ	这样子根本忍不住啊啊啊
「はひっ	「啊呀
ひあぁっ	啊啊
らめぇぇぇっ	不要～～～～～
「ひぃんっ	「咿嗯
ひぃぃぃぃんっ	咿咿咿咿咿嗯
「イっひゃふっ	「咿呀
まひゃぁぁぁぁ	唔嗯啊啊啊啊啊
「ひゃぁあいっぎ	「呀啊咿
刺激ッ強すぎてぇぇっ	刺激太强了噫噫噫噫
「イグッまたぁイグぅぅ！	「去惹又要去惹！！
「あぎゅうぅぅ	「啊咕唔唔
「こ、降伏…しゅるからあぁ……だからぁも……あひぃぃああ	「我、我认输了…所以，所以说，不要再…噫啊啊啊
「も、もぅやめぇ	「已，已经够了
いっそ殺して…あ゛ッ	杀了我吧…啊啊
あひゃうぅうぅあうっ	啊呀噢噢噢噢
「くりゅぅぅぅっ	「咕唔唔唔
ひゅごいのまひゃきひゃぅぅっ	好腻害的高潮，又要来惹唔唔
「イきゅっ	「去了
ひくぅぅぅぅぅっ	去了啊啊啊啊啊
「きひゃあぁぁ	「噫啊呀呀呀
色ボケかニャ子にぃっ	请给色情下流的神奈子
ごほうびえっひがぁぁっ	更多的奖励吧嘿嘿
「イきゅぅ	「去惹
わらひぃ	唔啊噫噫
イきまきゅっひゃいまひゅぅぅぅぅっ	又要去惹又要去惹
「ひゅいぎぃぃいぃ	「咿呀呀啊
こうひゃんしましゅ	认苏惹啊啊啊
降っっ	认～～
伏しましゅぅぅう	输了啊啊啊啊～～
「かにゃこ触手しゃんたちの雌奴隷になりッッ	「神奈子是～～
ンひゃぁァい゛い゛ィッッ	触手酱的～～
ましたぁぁああアッッ	雌性奴隶了啊噫噫噫噫～～
「っひぅぅぅっ	「呜唔唔唔呜
も…ゆるひてぇ	请、请原谅我…
これいじょうっ戦えにゃいからぁ	这样子没有办法再战斗了啊啊
「降っ参…しましゅからぁ	「认输了…所以，所以啊
もぅ……アクメ許ひっ	请、请让我继续高潮吧～
へぎゃぁおっぁおぉおあおぁぉっ	哦啊啊啊哦哦哦噫哦哦哦
「イきゅぅぅぅっ	「去惹～～～～～
イっひゃいぅぅっ	去惹啊～～～～～～
「えっひなわらひっ	「请给下流的神奈子
もっろきもひよくひてくらさぁぁいっ	更多快乐的感觉吧～～
「ゆっ、ゆるひっ	「原、原谅我
ゆるひれぇぇぇっ	请原谅我～～～～～
「かにゃこぉっ	「神奈子现在～
イきまふっ	要去惹～～
「まらぁぁぁっ	「又要啊～～
まらきゅぅぅっ	又要～～～
イっひゃぅぅっ	去惹～～～～～～
かにゃこっ、イぐぅっぅぅぅぅぅっ	神奈子，去惹啊啊啊～～～～～
「ひあぁぁぁぁ	「呀啊啊啊啊
はひぃぃぃぃぃっ！	啊噫噫噫噫！
「ゆるひれっ	「请原谅我
ゆるひれくらひゃああぁぁっぁっ	请原谅我啊啊啊～～～～
「っっっぁ	「啊～～～
ひあぁぁぁっ	呃啊呀呀～～
「イっへるっ	去了～～
イっへまひゅぅぅぅっ	又去了啊啊～～～
ゆるひれっ	请放过我
イくぅぅぅっ	请放过我吧～～～
「わらひっ	「我～
いまっ	现在
イっひゃっ	去了～～
らめなのにぃっ	明明不能去的～～
「らっ	「不行～～
めぇぇっ	不行的啊～～～
「イくっ	「高潮～～～
イき狂うっ	高潮的要疯掉了啊～～～
きもひよしゅぎれぇぇっ	舒服的太过头了～～～～
「ひいいぃいっ	「噫～～～～
あひぃぃんっ	「啊哦哦哦哦哦～～～」
もうゆるひれえぇえぇっ	真的请原谅我吧啊啊啊～～～～
「アァア゛～～～～～	「啊啊啊～～～～～
「ひくぅぅぅっ	「去惹～～～～
ひっひゃゅぅっ	去惹啊啊啊～～～～
「イきにゃがらぁぁぁっ	「不想去啊～～
まひゃひくぅぅぅぅぅっ	又要去惹啊啊～～～～
「ゆるひれぇぇっ	「放过我吧～～～
もうやらぁぁぁっ	已经不想再去了啊～～～～～
「イっへっ	「高潮～～～
まひゃイきゅぅぅぅっ	又要高潮惹～～～
「へごおぉぉっ	「啊啊啊～～
おごあっっ	唔哦～～～
おあぁぁああっ	哦啊啊啊～～
「あ゛～～～～～っ	「啊～～～～～
あ゛～～～～～～～っ	啊～～～～～～～
「イくぅ	「去了～
イっへるっ	又去惹～～～
イっきまくってぅぅっ	一直在去一直在高潮啊啊啊～～～～
「イっへる、の、にぃぃっ	「去惹啊～～～但是
イきながらっ	一边在高潮～～
イきながらイっきゅ～～～っ	一边在去的同时又有新的高潮哦哦哦～～～～
「イっ、きゅぅっ	「要，要去了～～～
こんにゃのっ	这样子的高潮～
こんにゃのらめぇぇええぇぇぇぇ～～～～っ	我不要啊啊～～～～
「ふあぁぁぁっ	「呼啊啊～～
りゃ、め	不、要
これりゃめぇぇぇっ	这个不要啊～～～～
「ひゃぁぁぁっ	「呀啊～～
んうぅぅぅっ	唔～～～～～～
「あはあぁぁぁぁんっ	「呼啊～～～～～
きもひっ、よしゅぎれぇぇっ	这样子，好苏胡～～～～
「ふあぁ……	「呼啊......
「こ、これすごくてぇ…	「这、这感觉太强烈了啊...
からだ、がぁ	身体、啊～
「ゆるひれっ、ゆるひれぇぇぇっ	「原谅我，原谅我啊～～～～
もっ	请
ゆるひて	原谅
やめてぇ～～～～～～っ	住手啊～～～～～～～～～
「ひきたくなっ、ひきたくないよぉぉっ	「不想去啊、真的不想去啊
っひ、ひ～～～～っ	唔、噫～～～～～～
「ひあぁぁっ	「噫啊～～
「は、はげ、ひっ	「哈、哈啊、啊～～
またぁっ	又要
「らめぇぇ	「不要啊
それらなのぉ～～っ	那样的话要～～
「んあぁっ	「呐～
きもひいのもっとぉっ	舒服的感觉，想要更多～
「ああぁ	「哦哦
あぁぁあ	啊啊啊啊
「ばかな！……見ただけで子宮が…ひぃぃっ	「怎么会！......明明只是看到而已，子宫就...噫啊～～
「ぁ	「啊
うぁ	唔啊
すご	好厉害
おっき…	好大…
「だ、だめ、なのに、だめなのにぃっ	「不、不行、但是、明明知道不行的
「ほ、ほひくなってぇううぅっ	「不、不要停下来嘛嘿唔唔～～
おなか、たぷたぷになるまでそそがれてっ	直到肚子被精液灌得满满的喷出来为止～
孕みたくなっちゃぅぅっ	直到子宫怀孕为止～～
「おねがいひますぅっ	「求求你了～
おんばひらぁっ	我的“御柱”
いっぱい虐めれくらしゃあっ	尽情的蹂躏她吧～
んあ…あ゛あ゛ぁぁぁっっ	嗯...啊...啊啊啊...齁哦～～
「か、かにゃこのぉおちんちん	「神、神奈子的小鸡鸡
いっぱいずぶずぶして、ザー汁絞りとってぇぇ…	要更多地插进去，把杂鱼精液都滋噗滋噗地榨出来...
「ら、め	「不、不行
そ…そこおっ……	那、那里…
おひんひんっ！わらひ、らめなのぉぉ！！	那里！不要啊！我说了、不可以啊！！
「れ、れひゃ	「那、那里
れひゃうぅ	那里
ら、らめ	不、不行…
もっろっ	再也…
がまんひれっ	忍耐不了
おおおっ！おんばひらぁ！いぎいぃい	齁哦哦！御柱，御柱！噫噫噫～～～
%CALLNAME:(TARGET)%は激しく腰を突き上げながらも快感に耐え、オンバシラの底で神の粥を滾らせている…	%CALLNAME:(TARGET)%猛烈的耸动着腰部抽插着，同时忍耐着令人发狂的快感，神明的白粥的在御柱的根部沸腾着...
「おっおんばひらぁ！　もっと…いぢめてぇ	「御柱哦哦！更多地…欺负我的御柱！
ひんっ	呼
あうっ	啊
もっとぉぉっ	更多～
「ひぃいぅ…やめろぉぉッ	「噫呀...快住手啊～
それ以じょ……んうぅっ！！オンバシラを嬲るなぁあっ	这样的话……唔～～不要再玩弄御柱了啊～～
「だめ……だめぇえぇ	「不行…不要…
「あっ	「啊～
しゅっ	哦～
しゅごいのおぉっ	好厉害～
しょんなっ	怎么这样
やさしくぅぅぅ～～～っ	温柔一点啊啊啊～～～
「んぁっ	「嗯啊～
きゅんきゅんらめぇっ	紧紧地…不要
そんな締め付けられたらぁ	如果这么勒紧的话
おぉっんばひらぁぁ	我的御柱啊啊
破裂しちゃうぅぅ	会坏掉的哦哦～
「あ、うぅぅぐ…くそ……何故私はこんな……	「啊，呜呜呜咕...该死......为什么我会这样...
あふあぁぁぁ	啊呼啊啊啊～
「おちんぽっにゅるにゅるぅぅ	「肉棒滑溜溜～
しゅぐ射精しひゃうぅぅっ	厉害的射精要来惹～
「ああぁあ！も…だめぇ	「啊啊啊！不、不要
我慢…できらいいｘ	已经，忍不住了
おんばひらぁ……いれひゃへてくらひゃいぃ…	雌御柱…要发射惹噫…
「くッあぁ	「库啊啊
おのれぇ…	你这家伙...
この程度で屈服などおっぉおほぉぉんっ	怎么会在这种程度上屈服…
「ひ、うぅぅぅぅ～～～っ	「咿、唔唔唔唔唔～～～
っひ、っっっひっ	咿、噫噫噫！
己の肉棒を深く咥え込まれた%CALLNAME:(TARGET)%は、こみ上げてくる快感から必死に耐えている…	自己的肉棒被深深的吞了下去，%CALLNAME:(TARGET)%只能竭力忍住奔涌上来的快感...
やめぇ…	停下来...
ひゃぃぃぅ	噫唔
「やめ…てぇ	「停…下
やっ	啊
あっ	啊
そんなに…腰っ	那样的…腰
動かさないでくれぇぇっ	拜托不要动起来啊～
「ア゛ッ	「啊
お゛んぅ…	哦嗯...
おんにゃのこどおしぃ好きぃ	女孩子，喜欢……
「あひゃぁぃぃッ	「啊呀噫～
これ、んんうあッ	这个、嗯……啊
くしぇになるのぉぉっ…	好舒服啊…
「よ、よせぇ…おしりで、なんてぇ…」	「住、住手…屁股，怎么可以…」
「お、おしりっ、やめぇ…	「屁、屁股、不要…
きもひよく、なっれきてぇっ…	感觉好棒、为什么…
「だ！ダメだ早苗ぇ！そこは尻の……	「不！不可以啊早苗！那里是屁股的…
「んっ、あんぅぅうっ	「嗯，啊...
おひりっ、ひゅごっ	屁股、好棒～
おほぉぉぉっぅっ	哦哦哦哦～～
「はぅぅぅッ……つぅぅ	「哈唔……啧
よせ諏訪子ぉぉお……正気に戻……	住手诹访子……快点恢复正常吧……
「へあぁぁっっ	「呃啊啊啊～
ま、まらっ	又、又
うごいひゃ	动起来了啊
らめぇぇぇぇぇ～～～っ	不要啊～～～～～～～～
「尻でするのかぁ…ふふ、いいぞ入れても……ぉンッ！	「用屁股来做吗……fufu、很好，放进来吧……哼嗯！
んんぅうひぃぃぃッ	嗯嗯啊啊啊
こりぇぇ…ふとっしゅぎぃ	这个……太、太大了
「んあぁ…	「嗯啊啊...
お、おひりに、ずっぽりはいっひゃいまひたぁ…	菊、菊穴，被深深地插插进去了…
「お、おひりにっ、じゅぼじゅぼされひゃ	「菊、菊穴，啾啪啾啪的
あひゅぅ	啊唔唔
かにゃこッはぁもぉぉ…おおぉッ	神奈子啊啊，已、已经
尻あにゃ奴隷なんしゅぅぅ	成为了肛交上瘾的雌奴隶了啊～
もっひょぉぉ肛虐っしてぇぇ	更多、更多的蹂躏我的菊穴吧～～
「や、やめろぉお…胸はあぁあぁッ！」	「住、住手啊……胸部啊啊啊！」
「身体が、勝手にィィッ…イヤアァああッ！」	「身体、自己就……不要啊啊啊！」
「嫌…嫌あぁぁっ	「不要、不要啊啊啊
触手ッなんかにぃぃっ！	被触手这种东西！
ひいうっぅううっっ	噫哦哦哦哦～
「嫌っ…嫌あぁぁあッ	「讨厌…讨厌啊啊啊
おっぱいらめえぇぇえっ	胸部不要啊啊啊！！
「はぁあぁふっ、ふふ…そうだなぁ	「哈啊啊、呼…呵呵，是的啊
早苗は昔から、私のオッパイが好きだったもんなぁ…	早苗从以前开始、就很喜欢我的胸部呢…
「あひいいぅぅッ	「啊哈哦哦
上手くなったなぁ早苗ぇぇ	变得很拿手了嘛早苗啊～
「あ～～～～	「啊～～～～
あ゛～～～～	啊哦～～～～
「おっぱいしゅごいぃぃっ	「胸部、好棒～
あ	啊
い゛ッ	噫
イ゛っぐゅぅぅぅっ	去惹哦哦哦～
「ああぁぁぁんっ	「啊啊啊啊～
ああぁあああああんっ	啊啊啊啊啊啊～
おっぱひっ	神奈子哦～
淫乱乳袋いぎゅぅぅぅッッ	淫乱的奶子去惹哦～～～
「ばっ！バカ諏訪子ぉ！	「笨！笨蛋诹坊子！
こんな所で…あんっ	在这种地方...啊啊
！　ひぅぅう…	！噫唔唔…
歯を立てて吸うなぁあッ！	不要用牙齿咬啊啊啊！
「はいぃ…かにゃこのデカ乳で奉仕いたしまひゅ	「好的…用神奈子的大奶子为您服务
「おっぱひっ	「胸部哦
むにむにされたらけれぇっ	被一直揉下去的话～
わらひっ	唔哈哈
しゅぐにぃぃっ	好腻害噫～
「神奈子はオッパイ奴隷なんれすぅ	「神奈子是淫乳奴隶哦～
淫乱おっぱい一杯いぢめてくらひゃいぃ	更多的蹂躏我淫乱的胸部吧～
ふあっ	呼啊
「やぁぁあ	「噫啊啊啊
体…かってにぃぃっ	身体…擅自的啊啊
「あぁそんなぁあ	「啊啊怎么会啊
このわらひがぁ	我居然
催眠じゅつなんかにぃぃ	对这种催眠术什么的噫
「…はうぅ	「......唔啊
ふあぁっちちうえぇッ	呼啊奶、奶子哦哦
い、いじわるしにゃいれよぉ	不、不要捉弄人哦哦
かにゃこぉ、いいこにしゅるからぁっ	神奈子，会做个好孩子的
はやくぅきもちいのしてよぉ	所以快一点，给我更多舒服的感觉嘛
「へううぅうあっ	「呃噢噢噢噢～
あふぅぅぅんんっ	啊呜呜呜嗯嗯～
「ひゅごい、ひゅごいのおおぉっ	「好棒，好棒哦哦哦
おまんこっ、こすこすしゃれてぇぇっ	小穴，噗唆噗嗦得被摩擦着噫
かにゃこはぁっ、めすぶたにぃぃっ	神奈子，成为淫乱的母猪了噫～
「ふあぁぁっ	「呼啊啊啊
も、ぬるぬるれすねぇ	已经，黏糊糊的了啊
%CALLNAME:(TARGET)%は触手の上にまたがり、ゆっくりと割れ目を擦り付けている…	%CALLNAME:(TARGET)%正坐在触手上，缓慢地摩擦着自己粘稠的雌性裂缝...
「…じゅぶじゅぶひて、ほしいんれすぅっ	「啾啪啾啪黏糊糊的、好像要啊
おねがいひまふっ、いれてくらさぁいっ	拜托了，请放进来吧！
こすれて、きもひいいれすぅっ	被摩擦着、感觉好舒服～
「ふふっ、まら、いれちゃらめれすよぉ	「呵呵、还不行哦，还不能放进去
クリちゃんこすこすひて、きもひよくなりたいんれすぅっ	阴蒂酱被库撒库撒的摩擦着、感觉好舒服啊
「あぁッッ	「啊啊啊
おのりぇぇ……おのりぇぇぇ～～ッッ	可恶……可恶啊～～
わたしのかりゃだぁ	我的身体…！
「かりゃだがっ	「身体
勝手にぃぃっ	擅自的
んひゃぁうぅ	嗯啊啊啊
「らめっ	「不要
そこっ	那里
らめえぇえっ	不行啊啊啊！
「おくっ	「里面
こつこつされてっ	被咕啾咕啾的抽插着
きもひよくぅっ	感觉好棒～
「ひゃあぁあッらめぇ	「呀啊啊住手啊
よせ、早苗ぇッッ正気にもどれぇ	停下、早苗、快点清醒过来啊！
「こんなところでぇっ	「在这种地方
ひぎいぃぃッ！ダメだ、こんなことおぉ	噫噫！不行啊，这种事情哦哦
%CALLNAME:(TARGET)%の目には、ヒュプノが愛しい巫女に見えているようだ…。	%CALLNAME:(TARGET)%被催眠的双眼中，看到了她那可爱的巫女…。
「ばッ！バカぁ！	「笨、笨蛋！
んッ！ア゛ア゛ァ～～ッ	嗯！啊啊啊～～！！
何をするんだ諏訪子おぉッ	你在干什么啊诹坊子！
「ふざけてる場合かぁ	「现在是开玩笑的场合吗笨蛋！
ッんひッぃいぃっ！！	嗯噫噫噫～
やめ……やめてぇぇッ	住...快住手啊啊
「きゃあああんっ	「呀啊啊！！
しょっ	这
しょんなぁっ	这样
ずぼずぼっ	啾啪啾啪的
らめ、らめぇぇぇぇっ	不要、不要啊啊啊！
「ひくっ	「去惹
しゅぐにぃぃぃぃっ	好腻害噫噫噫噫～
「…ふあぁぁ…	「…唔啊啊啊…
ふといの、わらッひのっおまんこにぃ	粗大的、在我的小穴里面～
おくまれぇごりごりっってぇ	咕哩咕哩的深入摩擦着！
「んあぁぁぁっ	「恩哇啊啊啊嗯
ふああぁぁぁっ	呼啊啊啊啊！
「しゅごいぃぃっ	「好腻害～
おまんこしゅごいぃぃぃぃ	小穴好腻害啊啊啊～
「んぅ	「嗯啊
ああぁああいいいぐ	啊啊啊啊去惹
「まんこっ！	「小穴！
かにゃこのバカマンッ！いっぢゃううぅぅッ	神奈子的笨蛋小穴！要去了啊啊啊～
あぁッんッ	嗯啊啊啊
「も……がまんれきまひぇぇえん	「已经…忍耐不住了啊啊
淫乱神奈子に、御仕置きくらひゃいっ	请对淫乱的神奈子，进行惩罚吧！
「ご主人様ぁ、どうぞ、おめしあがりくらはいぃ	「主、主人啊啊，请、请享用吧～～
「かにゃこはもう、いつでも食べられる準備ができていましゅぅっ…	「神奈子已经，随时做好被享用的准备了…
「はあぁ～～ッ	「呃啊啊～～
「ご主人様あぁ～～	「主人啊啊～
もっとかにゃこを、いじめてくらひゃいぃ	请更多的，蹂躏神奈子吧啊啊
きれっ	好棒
いっぱいいじめてくらさぁいっ	请更多的蹂躏我吧～！
「ご、ご主人様、お情けをぉ…	「主、主人，请大发慈悲…
「も、もぅかにゃこぉっ……おかひくなっちゃうぅぅ	「已经、神奈子已经…要坏掉了呜呜～
「も、もぉ…だめぇぇッ	「已、已经…不行了
我慢……できない	忍耐……不了啊
「あぁ…もうだめだ…」	「啊啊...已经不行了...」
「身も……心も………	「身体也……心灵也……
「あぁぁダメだ…だめ……なのにぃ	「啊啊啊不行啊…明明不行……但是
身体がコイツを……欲しがってぇ	身体在……渴望这个
「私……もうっ	「我......已经
「も……もう無理」	「已……已经不行了」
「我慢……できないよぉ…	「忍耐……不了了啊…
「ふむ、ここは私がひきうけよう」	「呼嗯，这里由我来解决」
「何、ちょろいもんさ」	「什么，小菜一碟罢了」
「うぅう……本当にこれ、やらなきゃダメなのか？」	「唔唔……真的要这样嘛？」
「くっ…こんな化生にまで頼らなくてはならないとは……」	「咕……竟然要依靠这种怪物……」
「八坂の名も地に落ちた……」	「八坂的名望也跌落尘埃了……」
「はぁ～～っ	「呼啊～～
はやくちょうだいっ	快点给我～
えっちなかにゃこに、きもちいのちょうだいぃッ	给色情的神奈子，更多舒服的感觉～
「ろこれもっ、ろこれもいいのぉっ	「这个也可以，这个也好棒～
いじめれっ	欺负我
きもひよくひてぇぇっ	给我更多舒服的感觉～
「んあっ	「嗯啊～
いいっ、これ……しゅごしゅぎぃっ	好棒、这个……太厉害了哦～
「もっと……もっとしてえぇ	「更多……给我更多
「はぁ～～	「哈啊～～
ケツマンコッ	菊穴
ケツマンコにちょうだいぃっ	更多的欺负菊穴～
「かにゃこの、ケツ穴にぃっ	「神奈子的，淫乱菊穴
しゅごいのちょおらいぃっ	想要更多舒服的感觉～
「んほぉぉぉっ	「嗯哦哦哦～
おひりっ	屁股
おひりぃぃぃッッ	屁股哦哦哦～
「おひりのあなぁぁ	「屁股的小穴
ひろがってぇぇ	被打开了哦哦
ひゃぁいぃぃいぃんんんッッ	好、好棒噫噫噫噫～～～
「ひッ	「屁、
ひりのあにゃぁあっ	屁股的小穴啊啊啊～
「もっとっっ	「更多～～
ケツマンコ貫いてぇぇぇ	贯穿我的菊穴哦哦～～
おほぉぉぉぉぉっっ	哦哦哦哦哦～～
「かにゃこのケツ穴ぁ	「神奈子的屁股小穴啊
ガバガバにしてぇぇぇっ	把塔弄得松松垮垮的吧～
「あひいぃぃいっ	「啊噫噫噫～～
ち、乳首ぃぃぃッッ	乳、乳首哦哦哦～
「先っぽぉ敏感なのぉぉおッッ	「顶端非常敏感的哦哦～
「ひゃぎゅぅぅうぅ	「唔噢哦哦哦
？！　乳首コリコリきもちいぃぃ	乳首被咕哩咕哩的摩擦好舒服唔～～～
もっと虐めてぇッ	更多的欺负我噢哦哦哦～
「かにゃこのドＭ乳首ぃッ	「神奈子的抖M乳首哦～～
引き千切るくらいにぃぃぃッッ	太刺激要裂开了啊啊～～
%CALLNAME:(TARGET)%は、すっかり拡張開発されきった乳腺の穴を広げ、挿入をねだった。	%CALLNAME:(TARGET)%打开了已经被完全扩张并开发了乳腺的乳首小穴，乞求着插入。
「こっ…ここっにもおお゛ぉぉッ	「这...这里...这里也要哦哦哦
おっぱいのっ穴にもぉぉ	胸部的雌穴也想要哦～～
ぎゅっぽぎゅっぽ！挿入れてくらひゃあぁあい	啾啪啾啪的！请插进来啊啊啊～
「いいきゅゅぅっ	「去了哦哦哦～
かにゃこのぉぉッッミルクタンクぅぅ	神奈子的乳汁袋子去了哦哦～～～
「はやくッ射乳したくてぇぇ疼くんれすぅう	「快点哦哦奶子已经涨痛的不行了想要把乳汁全射出来啊啊
グリグリ揉みしだいてぇ、虐めてくりゃひゃいぃぃっ	用力揉我的奶子、更多的蹂躏我哦哦哦～～
「んうぅぅうーーっっ	「唔嗯嗯嗯嗯～～
デカちちきもちいよぉぉッ	大奶子感觉好棒哦哦哦哦～～
「んあぁぁーーッッ	「嗯啊啊啊啊啊啊——
もっとぉぉっもっと絞ってぇぇ	更多、更多的勒紧啊啊啊
「あひア゛ア゛ァァッ	「噫啊啊啊啊
ミルキュタンク揉まれて…こんにゃ大きくなっひゃったぁぁ	乳袋被这样揉着…变得好大了啊
「あひゃあぁぁぁっ	「啊呀呀呀呀呀～
おっぱいいいのぉぉっ	胸部，好棒哦～～～
「もっとッッ	「更多～
もっと強く揉んでぇぇッ	更用力的揉啊～
「ひゃッあ゛あぁんっ	「哈啊啊啊啊～
敏ッ感ッおっぱいにぃ……気持ちいのきたぁ	敏感的胸部……好舒服的来了啊～～～
「うひぃぁあぁっ	「唔噫啊啊～
おっぱいもっとしてぇぇ	胸部、还想要更多～
「かにゃこのデカぱいぃッ淫っ乱でぇ……すぐイッひゃうからぁあ	「玩弄神奈子的淫乱大奶子……腻害的感觉要来了啊啊～～
「いいのぉっ	「好棒～
おっぱいいィィっ	胸部好棒啊～
「んっ……はぁぁあんっ	「嗯......哈啊啊～
おっぱい、きもひいぃよぉぉ	胸部，好舒服啊～～
「はぁぁぁ	「哈啊啊
しょくしゅのくしぇにぃぃ	触手在虐待
わた…しの……弱点んッ	我...的...弱点啊
「お゛お゛ぉっほぉぉぉぉっ	「唔噢噢噢噢哦哦哦～～～
かにゃこのおぢんぼぉぉッ	神奈子的肉棒哦～
淫乱メス竿ぉぉぉっ	淫乱的雌竿啊啊啊～～～
「イぎゅっ	「去惹～～～
しゅぐイッぢゃうぅんんぁぁあ゛あ゛っ	好厉害的去惹哦哦哦～～
「あぁんんぅっ	「啊啊啊啊嗯嗯呢
おんばひらきたぁぁっ	雌御柱啊啊啊～～
これしゅきぃぃっ	喜欢，喜欢～～～
「きもひっ！よしゅぎてぇえっ	「舒服～～感觉太爽惹呃呃呃～～
かにゃこッ！チンポバカになりゅぅぅうぅｘッ	神奈子！变成肉棒白痴了啊啊啊～～～
%CALLNAME:(TARGET)%の醜く開発されてしまったオンバシラは、触手によって容赦なく蹂躙された。	无数的触手无情的蹂躏着%CALLNAME:(TARGET)%那丑陋的被开发了的“御柱”！
血管を浮かび上がらせビクビクと痙攣する、身の丈にも及ぶ巨大な竿は幾本もの巻きついた触手によって、まるでボンレスハムのように、扱き、縛り上げられ	几乎一人长的巨大肉竿上青筋浮现，颤抖着痉挛，像无骨的火腿一样被几根触手束缚起来不断地拍打着
真っ黒な亀頭の先に蓋をする、滴る事のない超粘質カウパーを掻き分けるように、竿の内部にまで極細触手が侵入し嬲られ	根极细的触手挖开了黑乎乎的龟头上覆盖着几乎不会滴落的超浓稠前列腺液，深入肉竿的内部不断地责弄着
その付け根にぶら下がる、熱く滾った粥のような本番汁を蓄えた巨大な睾丸まで、口の付いた触手でシャブられている。	挂在巨大肉根下方、像是装满了煮沸的粥一样浓稠精液的巨大睾丸、也被长着嘴的触手不断地吮吸着。
「ほぎゃぁっ…ぉ゛お゛ぉぉっ	「呜嘎啊……噢……哦哦……
んがぁあが	呜哦哦
あぎゃひぃぃイ゛っ	呃啊咿
その極悪な快感の暴虐の前に、さしもの軍神・八坂神奈子も白目を剥き、舌を突き出して無様に喘ぎ、呼吸すらままならない有様だ。	在那极恶的暴虐快感面前，即使是传说的军神・八坂神奈子也只能翻白眼、吐舌头、丑陋地挣扎着喘息。
「お゛ッん゛ん゛んぅぅぅッッ	「哦……呜呜呜……
ひゃぃいぃぎ	嘻喔喀……
おごがぁ……んがっ	求求你……呜呃啊啊……
その極悪な快感の暴虐の前に、快楽を求めるだけの器官と成り果てた%CALLNAME:(TARGET)%のオンバシラは、すぐにも射精してしまいそうだ。	在那极恶的暴虐快感面前，%CALLNAME:(TARGET)%的雌御柱变成了只能追求快乐的性器官，似乎马上就要射精了。
「アアァんッ	「啊啊啊啊～
お豆ッ、お豆ぇぇッッ	肉豆、肉豆啊啊啊～～
あひぃぃいんッッ	啊噫噫噫噫～～
「しゅごいてぇえ	「好厉害～～
もっとごしごししてェェッ！	更多、更多咕啾咕啾的摩擦～
気持ちよくしてぇええ	感觉好舒服唔唔～～
「クリこりこりいいにょぉぉぉっ	「阴蒂咕哩咕哩的摩擦、好棒哦哦哦～～
「おひぃぃぃッッ	「哦噫噫噫噫～～
かにゃこのお豆ぇ、悪い子なんれしゅぅ	神奈子的小豆豆，是坏孩子
だからぁ、もっと御仕置きしてえぇぇッ	所以呢，请更严厉的惩罚吧啊啊～～
「はぅぅうあぁっ	「哈啊啊啊～
クリぐりぐりされるのっしゅごぃぃよぉぉぉッ	阴蒂被咕哩咕哩的揉动好腻害哦哦哦～～～
「やッ、ああぁんんっ	「呀、啊啊啊嗯～
じらさないでえぇえ	不要再挑逗我了啊～
はやく……はやくぶち抜いてェェッ！	快点……快点插进来～
「はあぁッ……んんんぅ～	「哈啊……嗯嗯嗯～
せつないのッ……	心痛的话......
意地悪しないでぇ…はやく、挿入ちょうらいぃぃ	不要再恶作剧了…快点、插进来吧～
「あッんんぅぅううぅ～	「啊嗯嗯嗯唔唔唔唔～～
きたっ	来了～
挿入きたぁぁああッ	插入来啦啊啊啊～～
すごっ	好棒～
なかっ	里面～
えぐられてぇっ	被贯穿了～
まんこ……いぎゅぅぅぅっ	小穴……去了噢哦哦哦～～
「へぎゅぅぅぅぅッ	「去惹噢哦哦哦～～～
もっとぉ……もっと奥までぇぇえッ	更多……更多的深入进来啊～～～
「貫いて……	「贯穿……
串刺しにしてぇぇッッ！	刺穿我啊啊啊～～
「かにゃこの体ぶち抜いてぇッッ	「把神奈子的身体打穿哦哦～
犯してッ	侵犯我～
イかせてっ	让我～
ヤり殺してぇぇッッ！	舒服到死吧啊～～～
「ひゃぁ…あひっぃいっ	「呜哇...啊噫噫～～
「そこ、ちがっ…	「那里，不对…
あああんんんっ	啊啊啊嗯嗯嗯～
…そこじゃ…ないのにぃぃっ	…不是…那里噫噫～
「んんぅぅっ、お尻が…ケツマンコがいいよぉぉ…」	「唔嗯嗯嗯、屁股…屁股小穴好舒服啊啊～」
「やらぁぁ！おっぱい……おっぱいにちょうだいぃぃッ」	「呀啊啊啊！胸部......快点玩弄我的胸部啊啊啊～～」
「はっ……ひぃぃ…おんばひら…オンバシラにしてェェッ」	「哈……呼唔……御柱……雌御柱想要哦哦哦～～」
「はっ……ひぃぃ…クリ…クリトリスにしてェェッ」	「咿……嗯嗯……阴蒂……玩弄我的阴蒂吧啊啊啊～～」
「はふぅぅぅん…ここ、だよぉ……おマンコに欲しいんだよぉッ」	「哈唔唔唔......这里、哟......小穴里面，想要～～」
「うぅぅ……足りない……切ないよぉ」	「唔唔唔……完全不够……好难受啊……还想要更多！」
「くひいぃぃっ	「唔噫～～～
おひりぃっ	屁股
いきなりにゃんてぇぇっ	太突然了～
「ひゃあぁぃいぃ	「哈噫噫噫～～
おっぱぃ！　おっぱいらめぇ！	胸部！胸部不行啊！
敏ッ感すぎるからぁ	那里太敏感了啊～～
「乳アクメッ	「乳首高潮～～
しゅぐイッちゃうのぉぉっ	马上要来了哦哦哦～～～
「ひぃぃいぃんんんっ	「啊噫噫噫噫～～～
おっぱいらめぇ	胸部不行啊～～
「ゆるひてくりゃはいぃっ	「轻一点揉弄啊～
おっぱいはぁぁっ	胸部啊啊啊～～
「あ゛ッ！！	「啊！！
ンア゛ァァ～ッ	嗯啊啊啊啊～～
おっぱいイぎゅうぅぅぅっ	胸部去惹～～～～
「あ゛ぁ゛ッぁぁぁあっっ	「啊啊啊啊啊啊啊～～～～
ちんぽ……チンポらめェええぇえ！！	鸡巴......鸡巴不行啊～～～！！！
敏感オンバシラッ壊れちゃううぅぅ	敏感的雌御柱要坏掉了哦哦哦～～～
「ふぎゅぅぅぅうぁ	「唔呜呜呜～～
おオンバひラがぁぁあっ！！	御柱、雌御柱啊～～！！
ア゛ッッううぁああ゛ッ	啊啊啊啊～～唔啊啊～～
「ぃぃいイぐっ	「去惹～～～～
オンバシラッ爆発しちゃうぅぅ	雌御柱大爆发哦哦哦
「へえあああがぁっ	「呃唔啊啊啊啊～
おちんぼアクメぇぇ	鸡巴高潮～～
強すぎてぇぇ破裂しちゃぅっ	感觉太强了～要坏掉了哦哦哦～～～
「ひいぃぃぃいっ	「噫噫噫呃呃呃～
クリっ、クリらめえぇぅぅっ	阴蒂、阴蒂不行～～～
お豆ゆるしてぇっ	放过小豆豆吧～～～
そんなぁっそんなぁあぁああ゛ぁ゛ぁ゛ッッ	不要、不要再玩弄了啊啊啊～～～～
「ひゃぁあやめ……	「哈啊、不要……
このっ触手のくしぇに焦らすなんてぇ	居然被触手这样的挑逗
ば、バカにするなあぁ	别、别再戏弄我了啊
「おげえ゛ぇ゛え゛っ	「哦呃呃啊
ぐっ	咕……
苦゛し゛っ	好痛苦
のにっ……	但是……
「どんどん気持ちよく	「变得越来越舒服了
イきたくなってりゅぅぅぅ	越来越想要高潮哦哦哦
「あ゛あ゛あぁぁぁっ	「啊啊啊啊啊～
まんこっ	小穴～
まんこ虐めしゅごいぃぃぃっ	这么虐待小穴好棒～
「や、やだぁ……尻穴でなんてぇっ	「不、不要……菊穴不可以啊～
なんで、感じてッ？！…いやあぁぁあ	为什么、会有感觉？！…不要啊啊啊
「あぁあぁらめ……らめぇ…	「啊啊不要……不要……
お尻らめぇえ	屁股不可以
あひぃぃぃぃんっ	啊啊噫噫噫～
「ひいぃぃうぅぅうんッッ	「噫噫噫唔唔嗯
お…おっぱぃぃ	胸、胸部
おっぱいらめぇぇえっ	胸部不行啊啊～
「やぁあやめぇぇっ	「不要不要不要
おっぱいぃぃ揉まにゃいれぇえ	不要再揉我的胸部了啊
わらひ……わらひぃぃぃっ	胸部有感觉了哦哦哦～
「んひぃぃぃぃッッ	「嗯啊啊啊～～
？！　おぉおぉッ…オンッバシラアァッァッ	？！啊啊啊啊…御柱哦哦哦
オンバシラぁイッちゃうのぉぉッ	雌御柱要射了哦哦哦～
「ひゃぁあああらめぇええッッ	「啊啊啊啊啊不要啊啊啊
オンバシラしごかにゃいれぇえぇッ	不要这样玩弄我的御柱啊啊啊
「こすこすらめえぇえっ	「不要再摩擦了啊啊啊～
はぁんっ	啊～
くりくりもっとらめぇっ	不要再摩擦小豆豆了啊啊啊～
すぐにっ、すぐにぃぃっ	好腻害、好腻害哦哦哦～
「ク、クリじゃ、なひゃあぁぁん	「小、小豆豆，不行啊啊啊～
い、いまっ	现、现在
びんかんしゅぎるの、にぃっ	太敏感了啊啊啊～
「…ひゃああん	「…啊哈嗯
そこらッめぇぇ…	那里不行啊…
「いれにゃいれぇぇえっ	「不要插进去啊～
中は…中はらめなのぉぉっ	里面…里面不行哦哦哦～
「ひんんんんっっ	「啊啊啊啊～
お願いだからやめてぇぇえぇ	求求你快点停下来啊啊啊～～
「他の場所は、どうしてもいいからぁ	「其他地方都可以，但是唯独那里不行啊～
中は……中は許してぇっ	里面……请放过小穴里面～
「あがぁあがっ	「噶啊啊啊啊～
「奥まで……届いて……	「最深处……被一直触及到……
そんにゃあぁ……	这种事……
中は……嫌なのにぃ……	明明……不喜欢被插进来的……
こんなにっ……きもちいなんてぇぇ	但是……为什么会、这么舒服～
「ひぃぃいいんんっっ	「啊噫噫噫噫噫～～
な、中はゆるし……	请、请放过小穴里面……
いぎゅああぁああッッ？！	去了哦噢噢噢噢？！
「おご……おご……あぁぁぁッッ	「嗯哦……嗯哦……啊啊啊啊～
奥……に、当たって……	深处……被、贯穿到了……
へうぅうあッ	嘿哦啊啊
あひやぁぁア゛ア゛ぁッッ	啊嗨呀啊啊啊啊
「これ…しゅごしゅぎてぇっ	「这个…太强烈了～
しゅぐイっちゃ……	要高潮了……
だめ……だめぇぇぇぇえぇえッッ	不行……不行啊啊啊啊啊啊啊啊
「くっ、触っるな！汚らわしい！」	「切，别碰我！太污秽了！」
「ひぃぃッ！」	「噫噢噢！」
「くそ…エロ同人みたいにっっ！」	「可恶…搞得就像是色情同人志一样！」
「ひぁあぁ！？」	「啊啊啊！？」
「く…屈するものかぁ！」	「决…绝不会屈服的！」
「ぐはぁあ？！…が……」	「哇噢？！…咕……」
「も……やめてく…れ……」	「拜托……快住手……啊……」
「あ、ぁぁッ	「啊、啊啊啊
このままじゃ	这样下去的话
ダメなのに、身体がぁ	明明不想要的、但是身体却
「私に酷い事する気か！江口同人みたいに！！」	「你这混蛋，要对我做过分的事情吗？！就像色情同人志那样的！！」
「ひぎゅぅぅうぅっ	「去惹哦哦哦～
「種付け、凄…お゛ぉぉぉお゛おんんッッ…	「被种付惹、好腻害…齁齁嗯嗯嗯…
「ああぁあ……あはは……	「啊啊啊……哈啊啊……
かにゃこの子宮……触手しゃんに種付けしゃれちゃったぁ……	神奈子的子宫……被触手大人灌满种子惹啊啊……
「神なのにぃ……軍神なのにぃ……	「明明是神灵……身为军神却……
「ヒギィィッ？！よ、よせ！……入ってくるなあぁ！」	「噫咿？！停、停下！......不要进来啊啊！」
「ひぐあぁあ？！まさか…種付けされて……嫌あぁぁっ！！」	「呀啊啊？！难道说…被种付了……不要啊啊啊！！」
「ふぅッ	「呼——
はぁっ	哈啊～
くッ、今当たったら……」	咕、现在被碰到的话……」
「へたくそめ」	「笨拙的杂鱼」
「あ…やめぇ……今、脱がさないでぇ！	「啊…住手……现在、不能脱掉！
「鉄火場で辱めを受けるのは初めてではない」	「在这种危机关头受到这样的屈辱也不是第一次了」
「だが、相手がコイツらでは……ッ！」	「但是，对手是这些家伙的话……！」
「やめ……もうやめれぇえ	「住手……快点住手啊
「こんな所でイかされてたまるか！」	「怎么可能会在这种地方被弄到高潮啊！」
「そ、それは、だめだッ	「那、那个、不行！
「させん！」	「休想！」
「へげぇッ…お……おぉんんんぅッ	「唔呃……齁……齁齁唔嗯
戦闘中の自慰によって盛大に射精した神奈子は、絶頂の余韻に白目をむいて痙攣し、立ち上がる気力もないようだ。	在战斗中因为自慰而盛大射精的神奈子、正处于高潮的快乐余韵当中翻着白眼、身体也不断地痉挛着。她已经连站立的余力都彻底没有了
「あへぇえああ……も…でにゃいぃ	「啊嘿噫噫噫咿咿……已经……不行了
神奈子は敵を前にした自慰によって盛大に射精し、その精力と共に体力を使い果たし、へたり込んでしまった。	神奈子在面对敌人时自慰并盛大的射精了、她的精力和体力因而消耗殆尽、最终瘫倒了下来。
触手の責めによって盛大に射精させられた神奈子は、絶頂の余韻に白目をむいて痙攣し、立ち上がる気力もないようだ。	在战斗中被触手玩弄到盛大射精的神奈子、正处于高潮的快乐余韵当中翻着白眼、身体也不断地痉挛着。她已经连站立的余力都彻底没有了
神奈子は触手の責めによって盛大に射精させられ、その精力と共に体力を使い果たし、へたり込んでしまった。	被触手玩弄到盛大射精的神奈子、耗尽了所有的精力和体力、最终瘫倒了下来。
「ぐハァッ！　ぬ、ぬかったわ……」	「咕啊啊！失、失策了……」
自慰によって盛大に射精した神奈子は、絶頂の余韻に白目をむいて痙攣し、立ち上がる気力もないようだ。	因为自慰而盛大射精的神奈子、正处于高潮的快乐余韵当中翻着白眼、身体也不断地痉挛着。她已经连站立的余力都彻底没有了
神奈子は自慰によって盛大に射精し、その精力と共に体力を使い果たし、へたり込んでしまった。	自慰到盛大射精的神奈子、耗尽了所有的体力、最终瘫倒了下来。
オンバシラを責めたてられ盛大に射精させられた神奈子は、絶頂の余韻に白目をむいて痙攣し、立ち上がる気力もないようだ。	因为雌御柱被玩弄而盛大射精的神奈子、正处于高潮的快乐余韵当中翻着白眼、身体也不断地痉挛着。她已经连站立的余力都彻底没有了。
神奈子はオンバシラへの責めによって盛大に射精させられ、その精力と共に体力を使い果たし、へたり込んでしまった。	因为御柱被玩弄而盛大射精的神奈子、耗尽了所有的体力与精力、最终瘫倒了下来。
「ぐふうッ！　く、なんて様だ……」	「嗯呃！这、这是什么情况……」
「嫌あア゛ァッッ！もうやめてぇ！！」	「讨厌啊！快住手啊啊！！」
「や……やめて……」	「住……住手……」
「抵抗しないから……乱暴しないでぇッッ」	「已经不会反抗了所以……不要那么粗暴啊呃」
「うあぁぁ服が…(このまま、犯されて……	「唔啊啊衣服被…（这样下去、要被侵犯了……
「――ッ？！…ち、違う！…期待なんてしてないぃっ！！」	「――呃？！…不、不对！…我才没有期待什么！！」
「くっ！…こんな奴らに辱めを受けるとは！」	「咕！…竟然被这种家伙给羞辱！」
「ふ、服が…	「衣、衣服…
肌が直接うぅっん	身体暴露在空气中了
「ひゃぁっ	「哇啊
「まずい……このままじゃぁ	「不妙……这样下去的话
「ふんっ、この方が返って動きやすいわ」	「哼、这样反而容易行动呢」
「全力でお返ししてやろう！」	「我会全力以赴回敬你的！」
「諏訪大戦を思い出す……燃えてきたぞっ！」	「让我想到了当初的诹坊大战……热血沸腾起来了！」
「ちぃっ…お気に入りの服だったのに」	「切…这件衣服可是我最喜欢的」
「―――ッがはぁ？！」	「——嘎哈？！」
「寝込みを襲われるとは、不覚！」	「居然在睡梦中被偷袭了、真是大意！」
「うぅ……ｚｚｚ……」	「嗯……ZZZ……」
『あぁ～ん、逃げちゃダメですよ、もう一人の神奈子さまぁ～☆』	『嗯啊～逃跑是不行的哟，另一个神奈子大人～☆』
『こぉんなに気持ちイイ事を嫌がるなんて、ほんとバカな女よね♪』	『居然会讨厌这～么舒服的事情、还真是个笨蛋雌性呢♪』
『聞分けのない『私』には、たっぷりと中に注いで、教え込んであげないとねぇ	『对于听不进劝说的『我』，必须要满满的灌注进去、好好的教育呢
異形の触手と同化し快楽の権化と化した、早苗、諏訪子、そして淫魔の分身たる神奈子自身が	与异形的触手同化而成为快乐化身的早苗、诹访子、以及淫魔分身的神奈子自身。
神奈子の全てを吸い尽くそうと、触手を漲らせ、姦濫に絡み合いながら迫ってきた。	为了榨干神奈子的一切，触手的妖魔淫乱的纠缠在一起，蠕动鼓胀着不断地逼近。
「あぁああ…やだぁ……もうやめてぇ！」	「啊啊啊…不要啊……不要再做了！」
(身体が奴らを欲しがってる……いっそ、私も楽に……)	（身体在欲求着它们……不如、我也就这样解脱……）
「くっ、追いつかれた！」	「可恶、被追上了！」
「どうしても私を仕留めたいようだな……来い、ここで決着をつけてやる！」	「看来你似乎无论如何都想要除掉我啊……来吧，在这里让我们决一胜负！」
異形の触手と同化し快楽の権化と化した早苗は、主柱の淫乱さから分裂した瓜二つの淫魔に体を預け	与异形的触手同化，化为快乐的化身的早苗，将身体交给了自主柱的淫乱当中分裂出来的几乎一模一样的淫魔化身
艶かしい表情を浮かべたまま、本物の神奈子にまで食指を伸ばし始めた。	带着恍惚而妖媚的表情、开始对真正的神奈子伸出了觊觎之手。
「あぁぁ……早苗、何てことだ……」	「啊啊……早苗，怎么会这样……」
(あれが、私が望んでいる早苗なのか……私は早苗を、あんな風に……)	（那就是、我所期待的早苗吗……我希望把早苗、变成那样……）
「早苗ぇ！そいつは本当の私じゃない！正気に戻るんだよ！！」	「早苗！那不是真正的我！快点恢复正常吧！！」
「―――ダメか……もはやコレまで…いっそ楽にしてやるぞ、早苗！」	「---不行了吗……已经到这个地步了…干脆让你解脱吧、早苗！」
『あぁ～ん、逃げちゃダメですよ神奈子さまぁ～☆』	『啊啊～不可以逃跑哟，神奈子大人～☆』
『神奈子さまは私に、い～～っぱい犯されてイカされて、孕んで苗床になるんですからぁ☆』	『我要把神奈子大人侵犯无～数次、将高潮的极乐彻底烙印在神奈子大人的身体与脑海里、成为我怀孕的苗床哟☆』
触手と完全に一体化し、変わり果ててしまった早苗が、底を尽く事の無い煮え滾った性欲を叩きつけようと	与触手融为一体、在淫乱的极乐中彻底扭曲了的早苗、正在散发着深不见底的沸腾欲望
ぬらぬらと粘液の光る触手を滾らせながら、主柱である神奈子に迫る。	滑溜溜的、闪烁着黏液光泽的触手蠕动着、向着身为守矢主柱的神奈子迫近着。
「早苗ぇ…どうして、こんな……」	「早苗…为什么，会变成这样……」
(あぁ……いっそ私も……)	（啊啊……干脆我也……）
「私の巫女が……なんて様だよッ…！」	「我的巫女啊……为什么会变成这样……！」
「―――許せ早苗……もはや、お前は救えん！」	「―――原谅我吧早苗……已经、无法拯救你了！」
触手達の陵辱に屈し、身も心も性欲の権化へと作りかえられてしまった、守矢の一柱と巫女……	屈服于触手无止尽的凌辱、身体和心灵都被改造成了性欲化身的守失一柱与巫女……
彼女達は、唯一残った一柱である神奈子をも取り込もうと、粘液滴る無数の触手を絡み合わせながら伸ばしてきた。	她们与无数滴落着粘液的触手纠缠在一起，不断地迫近着、打算吞噬掉作为最后一柱的神奈子。
「うぅぐっ！……二人とも…どうして……」	「唔咕！……你们两个…为什么……」
(私も、あっち側に……そうすれば楽に……)	（我也、加入那边的话……就能获得快乐……）
「くっ！…どこまでも追ってくるつもりか」	「咕！…到哪里都要追上来吗！」
「―――こんな形で、守矢が終わるとは！」	「——这样下去的话、守矢就要完蛋了！」
『こぉんなに気持ちイイ事を嫌がるなんて、ほんとバカな女よね♪	『居然会讨厌这～么舒服的事情、还真是个笨蛋雌性呢♪
『もう諦めなさい神奈子…どこに逃げ隠れしたって見つけ出して、ぶっ壊れるまで犯しまくってやるんだから♪』	『放弃吧神奈子哟…无论你逃到哪里我都会找到你，然后一直一直的侵犯你直到你在快乐中彻底坏掉为止♪』
まるで神奈子の臭いを嗅ぎつけたかの様に、外法に堕ちた諏訪子が再び姿を現す……	就像嗅到了神奈子的气味一般、堕入外法的诹访子再次显现出来……
触手と一体化し、性欲を垂れ流すミジャグジを体に絡ませながら、かつての相方を取り込もうと食指を伸ばしてきた。	身上缠绕着触手、闪烁着粘稠光泽的黏液不断地从触腕上滴落、对着曾经的同伴伸出了觊觎之手，期望着将其完全吞噬。
「うぅぅ……諏訪子…何故そこまで私をッ」	「唔唔……诹访子…为什么要这样……」
(逃げても逃げても追ってくる…ならいっそ私も……)	（无论怎么逃都逃不掉…那我不如……）
「逃がしてはくれんか……ならば、取るべき手段は一つ……」	「不肯放我逃走吗……那么，剩下的手段就只有……」
「―――洩矢諏訪子……もう一度平らげてやる！」	「——洩矢诹访子……我将再次击败你！」
『あハッ！見つけたぁ♪……いくら逃げたって、無駄なのにねぇ？』	『啊哈！找到你了♪......不管逃多远都是徒劳的哟？』
神奈子の中の『触手の快楽に落ちた淫乱な精神』が、またしても具現化し、目の前に現れる。	神奈子内心深处那『沉溺于触手快感的淫乱精神』再次具现化，出现在了她眼前。
それは彼女の中に潜んでいた『何もかもかなぐり捨てて堕ちてしまいたい』という、もう一つの一面であり、抗いようの無い事実でもあった。	那是潜藏在神奈子内心深处『想要抛弃一切，彻底堕落于快乐』的黑暗面、也是无可抗拒的事实。
「ひぃぃっ！……やだ……もう、許してぇ……」	「噫！……不、不要……已经、别再来了……求求你、放过我……」
(逃げても、隠れてもッ…『私』は追ってくる！……だったらいっそ……)	（就算是逃跑、藏起来……『我』都会追过来！……既然如此，不如我也……）
「――くぅッ！追いつかれたか！」	「——唔！被追上了吗！」
「来い！私の身体が欲しいんだろう？！タダではくれてやらんがなぁ！」	「来吧！你是想要我的身体对吧？！怎么可能让你轻易得逞！」
「伏撃だと？！化生の分際で、私と同じ戦術を！」	「伏击？！这种怪物外道、居然也敢使用跟我相同的战术！」
「逃がすか！ここで仕留める！お前を外に出すわけにはいかない！」	「休想逃！就在这里解决你！绝不会放你逃到其他地方去！」
「ここで仕留める！お前を外に出すわけにはいかない！」	「就在这里解决你！绝不会放你到其他地方去！」
「……しまった！」	「……糟了！」
「だっ……だめぇ！……こんな状態じゃ……勝てっこない！」	「不……不行！……这样的状态……赢不了！」
「ふぅうぅッ…」	「呼…」
早く、終わらせないと！」	快点、尽快解决这个！」
「うっく……こんな状態じゃ……」	「唔……这种状态下……」
「しま……！」	「糟……！」
「……だめ……こんなの……諦めるしか！」	「……不行……这种状况的话……只能放弃了！」
「どうやら黒幕のようだねぇ」	「看起来好像有幕后黑手呢」
「外法の分際で、神を相手に舐めた真似するじゃあないか」	「身为邪魔外道、竟敢对神如此不敬！」
「……“根の国に”たたき返してくれよう」	「……就将你打回“根之国度”吧！」
「勝機！」	「胜机！」
「信仰の妨げになるものは一つ一つ排除しなくてはなりません」	「妨碍信仰之物就需要一一排除！」
「……ッ！？」	「……嗯！？」
「私の……娘……奴らとの…ッッ！」	「我的……女儿……和那些家伙的！」
「―――ここで、屠らなくては！」	「―――必须，在这里，杀掉！」
「早苗……その姿は……！」	「早苗……你的样子……！」
『神奈子さま……みぃつけたぁ……』	『神奈子大人……我找到您了……』
『見てください神奈子さまぁ、早苗の体……すっごくエッチにしてもらえたんですよぉ♪』	『请看啊神奈子大人，早苗的身体……已经变得这么淫乱下流了哟♪』
「何を言っているんだ早苗ぇ！正気にお戻り！」	「你在说什么啊早苗！快点恢复正常吧！」
『うふふ……私の神奈子さま……早苗がいっぱい気持ちよくしてあげますよ……』	『呵呵呵……我的神奈子大人……早苗会让你感觉非～常舒服的哟……』
「ぁぁあ早苗、なんて事だ……私の巫女が……」	「啊啊啊早苗、怎么会这样……我的巫女啊……」
『泣かなくてもいいんですよ神奈子様……』	『不需要哭泣哟神奈子大人……』
『受け入れて……信仰や神社の事なんて忘れて、一緒に堕ちてしまいましょう☆』	『接受这一切……把信仰与神社都抛之脑后，让我们一起堕落吧☆』
「……すまない、早苗……お前を救えなかった、不甲斐ない私を許しておくれ……」	「……对不起，早苗……没能拯救你，请原谅我这无能的神明……」
「――今すぐ、楽にしてやる！」	「――现在就，让你解脱！」
「な！……これは一体！」	「嗯？！……这究竟是！」
『あっははは……見つけたよ、『私』…』	『哈哈哈……找到了啊、『我』…』
『気持ちイイ事から逃げたい『私』、信仰に縛られた『私』、過去に脅える『ワ・タ・シ』♪』	『想逃避舒服的事情的『我』、被信仰所束缚的『我』、害怕过去的『我·自·己』♪』
「黙れ！！そんなはずがあるか！…私は…八坂神奈子はッ！」	「闭嘴！！怎么可能有这种事！…我可是…八坂神奈子啊！！」
『もう抵抗しなくていいんだよ…『私』の気持ちイイ事、全部知ってるんだから』	『不用再抵抗了吧……『我』心里的所渴望的那些快乐，我全都知道』
「黙れ！黙れ黙れ！……お願いだから……それ以上言わないで……」	「闭嘴！闭嘴闭嘴！……拜托了……不要再说了……」
『触手に犯されて中出しされてザーメン飲まされて気持ちよかった……』	『被触手侵犯，中出，不断地喝下精液，沉溺于那种快乐……』
『もっと膣内射精されて苗床にされて妊娠したい……だから『私』はここで『私』に犯されるの☆』	『想要被更多的精液射入身体，成为孕育之苗床……所以『我』将在这里被『我』给彻底侵犯☆』
「………我が名は……八坂・神奈子！」	「………吾名为……八坂・神奈子！」
「信仰の妨げになる者は、一つ残らず滅してくれる！」	「妨碍信仰之人，一个不剩全部消灭！」
『…あらっ♪』	『…哎呀♪』
「例えそれが……私の写し身であったとしても……」	「即使那是……我的分身……」
「諏訪子……？その姿は……まさか！」	「诹坊子……？那个样子……难道！」
『ケロケロ……神奈子みぃつけたぁ……』	『gerogero……找到神奈子了……』
『どう？私の新しい力……今度は私が、アンタを征服して犯しつくしてやるわぁ♪』	『怎么样？我的新力量……这次轮到我了咕、我会征服你、再彻底地侵犯你、直到快乐被彻底刻印在你的精神与肉体上♪』
「ちっ！祟り神が何て様だよ！……お前は、そんな玉じゃなかったろうに！」	「啧！祟神怎么能变成这幅模样！……你根本、不是这样的家伙啊！」
『ふふっ…強がってる割には足元が震えてるじゃないの……本当はアンタだって気持ちよくなりたい癖に』	『呵呵～…脚都已经在发抖了却还要逞强……其实你也很想变得舒服起来不是吗？』
「守矢諏訪子……その姿、見るに耐えんぞ」	「洩矢诹访子……那副姿态、真令人无法直视」
『……やろうってのね？いいわ、諏訪大戦のリベンジマッチをしましょう……』	『……要来战斗吗？好哇、让我们开始诹访大战的复仇战吧……』
『穴と言う穴ブチ犯して、使い物にならなくしてやるから☆』	『我要把你身上的每个穴都侵犯一遍、直到它们全都坏掉为止哟☆』
「……お前の“最後”は早苗には話さない」	「……我不会把你的“最后”告诉早苗」
「あの子の記憶の中で、昔のままの諏訪子でいさせてやる！」	「在那个孩子的记忆中、我会让你保持曾经诹访子的样子！」
「お前は、竹林の薬師……その姿は……！」	「你是、竹林的药师……那个样子是……！」
『あら、山の神様じゃないの……あなたも此処にいたのね……どうりで……』	『哎呀、原来是山上的神明啊……你也在这里啊……难怪……』
『地上の薄汚い国津神共の臭いがすると思ったわ♪』	『我就觉得地上有一股肮脏的国津神的味道呢♪』
「……なんだと」	「……什么？」
『……国譲り……タケミカヅチ……言いたい事わかる？』	『……国让……建御雷神……你明白我想要说什么吗？』
「―――ッッ……(歯がカタカタと震えている)」	「――唔……怎么会……」
『天津神が一柱……八意思兼神……』	『天津神之一柱……八意思兼神……』
『国譲りの時は命だけは助けてあげたけど……ふふ、ここでもう一度躾してあげるわ』	『国让时是我救了你一命……呵呵、那个拯救下来的身躯、让我在这里使用一下吧』
「――や、やだ…こっちへ来ないで！……」	「——不、不要…不要过来啊！……」
「諏訪子…早苗ぇ……誰か、助けて……嫌あぁぁッッ！」	「诹访子…早苗……谁来、谁来救救我啊……不要啊啊啊！！」
「くっ、ハァッッ……そん、な……こんな所で……」	「咕、哈啊……这、这里……在这种地方……」
「くっ、来るな……来ないでくれぇッ！……嫌あぁぁアッッ！」	「不、不要过来……不要过来啊啊啊啊！……讨厌啊啊啊啊！」
「誰か、助けて……父…上……」	「谁能、谁能帮帮我……父亲……大人……」
「諏訪子…早苗……すまない……私はもう……」	「诹访子…早苗…对不起……我……已经不行了……」
「……早苗……もう、お休み……」	「……早苗……晚安……好好休息吧」
「……八坂の名において、この落とし前はつけさせる！」	「……以八坂之名、吾必让它们付出代价！」
「……すまない早苗……お前の友達は、救えなかったよ」	「……抱歉早苗……我没有能、拯救你的朋友」
「……呆気ないものだな……あの祟り神が、こんな最後とは……」	「……真是无趣……那个祟神、居然落得这样的结局……」
「……すまん」	「……对不起」
「弾幕を撃つ気はないみたいだし……いったい何なのよ、もう？」	「好像没有发射弹幕的意思……这到底是怎么回事？」
「うッ、ぐ！……次は、無理だ……」	「呃、唔！……再来一次的话、就不行了……」
「他愛も無い」	「毫无意义」
「八坂の風が吹く……」	「八坂的风正在吹拂着……」
「はぁぁんんぅ……」	「哈啊啊嗯嗯……」
（どうして…逃げ切れたのに、身体が	（为什么…明明逃了出来，身体却
「ハァッ…ハァッ…」	「呼…呼…」
「……くっ！　この八坂神奈子が、なんて様だよ！」	「……咕！我堂堂八坂神奈子、居然沦落到这种地步！」
「撤退成功……次は、こうはいかんぞ」	「撤退成功……下次、不能再这样了」
「……ッッ……許せッ！」	「……呜呜……原谅我！」
「今の私には……」	「现在的我……」
「必ず助けに戻ってくる！」	「我一定会回来救你的！」
「いま少し耐えてくれ！」	「现在请再稍微坚持一会儿！」
「また私は捨てられるのか……」	「难道我又被抛弃了吗……」
「外の世界でも……この幻想郷でも……」	「无论是在外面的世界……还是这个幻想乡……」
「はぁ～～んぅッだめぇぇ	「哈啊啊啊～～不行啊
「見られてるにぃ……	「啊啊被看到了……
「ううぅぁぁ…見るなぁ……見ないでよぉぉっ	「唔唔唔啊啊…不要看……不要看我啊～
ゆるひれぇぇぇぇっ	放过窝哦哦哦哦～
「わら	「唔哦
こ、わ	咕、哇
「あ゛～～っ	「啊啊啊～～～～
あ゛～～～～っ	啊～～～～
「イっれっ	「进来
イっれるのにぃっ	继续进来
まらっ、イきゅぅぅぅっ	要、去惹哦哦哦～～～
イきまくって	一直在去
とまりゃにゃいぃぃぃっ	停不下来呀啊啊～～～
「はへぇぇっ	「哈啊啊啊～
ひいぃぃぃ	噫噫噫～～～
イぐっ	去了
イぎまぐるのぉぉっ	高潮完全停不下来哦哦～～
「へえあぁ	「呃啊啊啊～
あひぃ	啊噫
ひぃぃ	噫噫～～
アクみぇ	高潮
とまりゃにゃいぃぃっ	停不下来啊啊啊～
「イっへるのぉぉっ	「到了哦哦哦～
いっへるかりゃ	又在高潮了～
ゆるひてぇぇえっ	原谅我哦哦哦～
「えひぃぃあぁああっ	「欸呀啊啊啊啊～
も、らめぇえぇ	已经、不要再来了啊啊
たしゅけてぇぇ	救救我啊～～
「きゃひぃぃぃっ	「咕齁齁齁哦哦～
も	已经
イって	好痛
いってりゅからぁっ	说了好痛啊～
「ひっ	「高
くぅ	潮～
「わらひぃっ	「我哦
アクメ	高潮
きまったるからぁ	因为已经到了
これいじょう、イかさにゃいでぇっ	不要再来了哦哦哦～
「～～～～～っ	「～～～～～啊
～～～～～っ	～～～～～哦
「ひ、ひぎゅぅぅぅううっ	「去、去惹呃哦哦哦哦～
「あへあぁあぁぁぁ	「啊唉啊啊啊啊啊
「ひぃあぁぁぁっ	「噫噫啊啊啊～
あひぃぃいぃぃい	啊噫噫噫噫噫
「んおぉぉっ	「嗯哦哦哦～
おぉおッッ	啊啊啊哇啊
「おごぉおぉぉっ	「哦咕噢噢噢噢～
「あ―――ああっぁあ゛あ゛	「啊——啊啊啊啊啊
んあ゛あ゛ぁぁッッ	嗯啊啊啊啊啊～～
「は、ひ……	「啊、嗯……
ひっ、ひぃっ	咕、噫噫
「ぅ……ぁ……	「呃……啊……
～～～～～～～っ	～～～～～～～啊
「イっらぁっ	「到了～
イきまひたぁぁっ	到高潮了啊啊～
ああぁあぁぁぁっ	啊啊啊啊啊啊啊啊啊っ
「イきまひゅっ	「高潮了哦～
イっひゃいまひゅぅぅっ	我高潮了啊啊哦哦哦～～
「ひああぁぁぁん	「唔啊啊呜呜呜呜
「ふあぁぁぁぁ！ ひあぁあぁぁぁあん	「呼哇啊啊啊啊啊！噫啊啊啊啊！
「ひゅご、ひゅごいの、ひゅごいのきひぇましゅぅぅぅっ	「去了、去惹哦、又要去惹哦哦哦哦哦哦～
「ひぎゅぅぅううあ	「去惹啊啊哦哦～
こ、降参……	认、认输……
降参しましゅからぁぁあ	我已经认输了所以说啊啊啊
「も、アクメゆるひてぇえ	「不、不要再高潮了
イグの休ませ……	让我休息一下、不要再高潮了……
ああぁあ！またあぁぁああぁあが	啊啊啊啊！又要啊啊啊啊啊噶
こりぇっ	这个
これしゅごいぃぃっ	这个好厉害噫噫噫～
「ま、まらっ	「不、不要
イかひゃれぇっ	不要再让我高潮了啊啊
「ま、ひゃっ	「不、不要啊
も、もうわらひイってまひゅぅぅぅっ	已经、窝已经不能再高潮了噢哦哦哦哦～
「しゅごいの、しゅごいのきひぇまひゅぅぅぅっ	「好厉害、太厉害了哦又要去了噢哦哦哦～
イきゅぅっ	去惹～～
「あ	「啊
あ～～～っ	啊～～～哦
「これいじょうっ	「这样下去的话
しゃれたらっ	再这样下去
こわれぇぇっ	要坏掉惹呃哦哦
「れ、れもおぉぉっ	「不、已经哦哦哦
イっちゃいまひゅぅぅっ	又要去了噢哦哦哦
「まらっ	「等等
くるっ	来了哦～～
「きもひいいの	「好舒服唔哦哦
きひゃいましゅぅぅぅっ	好喜欢嗯哦哦哦～
「あひっ	「啊噫～
はひゃんっ	哈呀啊～
「ふあぁあぁぁっ	「呼啊啊啊啊～
やあぁぁあぁぁんっ	呀啊啊啊啊嗯～
「まひゃっ	「又要
らめぇっ	不要
イきまひゅうぅぅっ	去惹哦哦啊啊～
ひっ	噫呃
ひあっ	噫啊
ふにゃああぁぁぁぁん	呼嗯呀啊啊啊啊啊
「イっひゃっ	「去了～
イきまひゅうっ	我要去了～
しゅごいのきまひゅぅぅっ	太厉害了我又要去了哦～
「あはぁぁぁっ	「啊哈哈哈
イっちゃうぅぅっ	去了喔哦哦哦哦～
「ああぁあぁぁぁんっ！！！」	「啊啊啊啊啊啊啊啊——！！！」
「イっ、くっ	「去了、去了啊～
イっちゃい、まひゅうぅぅぅっ	要去了、真的要去了哦哦～
「ひあああぁぁぁん	「噫啊啊啊啊啊～
ま、まひゃっ	不、不行了～
まひゃイきまひゅぅぅっ	我又要到了齁哦哦哦～
「ん、んん～～～っ！」	「嗯、嗯嗯～～～！」
「っぁ…	「啊…
は…	哈…
「イっ……イっ、くぅぅぅぅっ	「高……高、潮噢哦哦哦哦～
「ぁ―――	「啊———
あぁぁ～～～っ	啊啊～～～
「～～～～っ	「～～～～哦
「うあぁぁぁ	「呃啊啊啊啊
……ぇぁぁ	……呃啊啊
「……ひ……	「……嗯……
うぅぅ～～～～っ	唔呃呃～～～～
くぅっ	潮哦～～
―――――っ	―――――
っっっっぁ	齁齁齁齁啊
「ひああぁあぁぁぁぁっ	「噫啊啊啊啊啊啊啊
「っあぁあぁぁぁーっ…	「齁啊啊啊啊——…
「みる、くっ、れっ……	「不、要、看我……
「こ、こぼれてりゅのおぉ	「溢、溢出来了啊啊
もっろゆっくりぃ	再慢一点
「じゃないと、わらひ、しゅぐにぃぃっ	「不然的话、我会、马上就～
しゅわないでぇえっ	不要、不要那样啊
「しょんなしゃれたらぁ、おっぱいこわれちゃうのぉぉっ	「这样玩弄下去的话、胸会坏掉的哦哦～
「ま、またっ	「又、又要
こどもにっ、おっぱいすわれてっ	被孩子、在乳袋上吮吸着
わらひっ、イっちゃあぁぁぁっ	高潮又要来了啊啊啊～
「あひぃっ	「啊噫
はひぃっ	哈啊！
「母乳っ、まらっ、でちゃうぅぅっ	「母乳、来了、出来了唔哦哦哦～
「らめぇえっ	「不要啊～
まらっ	又要
乳袋ビュービューしちゃぅぅっ	乳袋里的母乳要biubiu的射出来了哦哦～
「で、でちゃ……	「出、出来了……
らめっ、ら―――っ	不要、不——
「ま、まひゃっ	「等、等一下
おっぱいしぼられちゃぅのぉぉっ	这样粗暴的挤奶会坏掉的啊啊啊
「―――ッッ！！！」	「喔啊——！！！」
「フーーッ！フゥーーーッッ！」	「呼——！呼——呼唔!」
「くはぁッ？！……あがっ……」	「噶啊？！……啊啊……」
「どうせ紛いもの……後生大事に取っていたわけではないが……」	「怎么说也只是赝品……并不是我非常珍重的东西……」
「くはぁッ？！……ば、バカな……」	「什么？！……不、不可能……」
「生まれた子が、処女を破っただとぉ？！……」	「生下来的孩子、弄破了处女膜吗？！……」
「なっ……麓の巫女！」	「啊……山脚的巫女！」
「おい、しっかりするんだ！」	「喂、振作一点！」
「っ……！白黒の魔法使い……！」	「呃……！白黑的魔法使……！」
「これは……酷い！」	「这真是……不太妙啊……」
「――ッッ！！！！」	「――啊！！！！」
「さな…え……さなえーーーー！！」	「早、早苗，早苗ーーーー！！」
「まさか、諏訪子が……そんなっ！」	「怎么可能……诹访子居然、变成了这样！」
「おい、しっかりしろ！こんな様、早苗に見せられないだろ！」	「喂，振作点！这样的状况，不能让早苗看到吧！」
「くっ……これは、酷いな」	「啧……这真是……不太妙啊……」
「あら？麓の巫女じゃないの……」	「哦呀？这不是山脚下的巫女嘛……」
「この異変の解決も、時間の問題かしらねぇ？」	「解决这个异变、大概也只是时间问题吧？」
「ははっ、白黒の魔法使い」	「哈哈、黑白的魔法使」
「やはり、お前も居たか」	「果然，你也在这里啊」
「おー、早苗！無事だったか！」	「哦，早苗！平安无事吧！」
「怪我はないか？変な事されなかった？お腹はいたくないか？」	「有没有受伤？没有遭遇什么奇怪的事情吧？肚子不疼吧？」
「諏訪子じゃないか」	「这不是诹访子嘛？」
「張り切ってるか？あんまり暴れすぎるなよ……」	「你看上去很兴奋嘛？别太闹腾了哟……」
「ふふっ…見た顔がいると思ったら……」	「呵呵……好像是见过的面孔呢……」
「許せ、早苗ッッ！」	「原谅我，早苗！」
「応援を連れて、必ず助けに来るから！」	「我会带上援助、一定会回来救你的！」
「悪く思うな諏訪子……」	「不要想太多诹访子……」
「お前なら、耐えられると信じている！」	「如果是你的话、我相信你能坚持住！」
「――許せっ！」	「——原谅我！」
「ここで一度わかれるが……いいかい、早苗？無理はするんじゃないよ？」	「在这里暂时分别一下吧……听着，早苗，不要勉强自己哦？」
「お腹が痛くなったり、寂しくなったら、何時でも私を呼ぶんだ」	「如果肚子疼、或者感到寂寞的话时，随时记得叫我。」
「よぉ～～し、ここらで分かれて、挟み撃ちといくか？」	「好～～嗯，我们就先在这里分开，采取夹击的战术如何？」
「昔を思い出すなぁ諏訪子♪」	「让我想到了过去呢、诹访子♪」
「……気をつけてな」	「……小心一点」
「――はぁ……うっぐぅ……」	「——呼啊……咕嗯……」
「すまない、恩に着るよ……」	「抱歉，我会记住这份恩情的……」
「……言い逃れするつもりはない」	「……我不打算找什么借口」
「犯されて孕まされた……それだけだ」	「被侵犯并怀孕……仅此而已」
「大丈夫だよ早苗、私がついている」	「没关系的早苗、我会在这里陪着你」
「ふっふ～ん、さしもの祟り神も、今回ばかりはお手上げかな？」	「呵呵～嗯、即使是强大的祟神、这次似乎也束手无策了？」
『うっさいわねぇ！調子こくと、ブッ祟るわよ？』	『好烦啊！再这么得意忘形的话、我可要对你作祟了哦？』
「さて、これからどうするか」	「那么、接下来该怎么办呢？」
「すまない、恩に着るよ……何でも聞いてくれ、知ってる事なら何でも教えよう」	「抱歉、这份恩情我会记住的……有什么想知道的事吗？只要我知道，都会告诉你的」
「いいかい？早苗……私のいう事を、よ～くお聞き？」	「听到了吗？早苗……要仔细听我说得话，明白吗？」
「ヒソヒソ……諏訪子はペチャパイ……幼児体型のペド量産装置……」	「（低声）……诹访子是个搓衣板……幼儿体型的制造机……」
「そうそう諏訪子、胸を触手に弄られると大きくなるぞ？」	「对了对了、诹访子、如果让触手多玩弄一下你的胸部、它会变得更大哦？」
『……コロス』	『……杀了你哦？』
「――でねー？それでねー？」	「——这个呢？是这样吗？」
(…BBA臭いっつった奴表出ろ)	(...那个说我像BBA的混蛋站出来)
「悪く思うな……調(みつぎ)だと思うんだ」	「别往心里去……就当作是补偿吧」
「八坂神奈子……この恩は、一生忘れぬ！」	「八坂神奈子……一生不会忘记这份恩情的！」
「悪いね早苗、ちゃんと役立てるからね」	「对不起早苗、我会好好利用它的」
「ケチケチしないで、さっさとよこすんだよ」	「不要吝啬、把东西给我吧」
『あーうー……ひょっとして、私いいように利用されてる？』	『啊唔……难道说，我被人给利用了吗？』
「うむ、いい心がけです(外交モード)」	「恩姆，心态很不错（外交模式）」
「もう大丈夫だぞ早苗！いっしょに連れて行ってやる！」	「已经没问题了早苗！我会带你一起出去的！」
『――神奈子…さま……？』	『――神奈子…大人……？』
「しっかりしろ祟り神！そんな様を早苗に見せられるのか！」	「振作起来祟神！你这个样子能让早苗看到吗！」
『――かな…こ……』	『――神奈…子……』
「この八坂神奈子が来たからには、もう心配には及びません」	「既然吾八坂神奈子来了，就没有什么好担心的了」
「うっぐ…！すまない、早苗……無様な所を見せてしまったな」	「呃……！抱歉，早苗……让你看见了我不中用的样子」
「くふっ…！諏訪子か……」	「咳唔……！是诹访子啊……」
『ザマぁないわね神奈子、こんなみっともない神に負けた憶えはないわ……』	『真丢人啊神奈子、我可不记得我输给过这么不堪一击的神明……』
「言うな諏訪子、今はお前が頼りだ……」	「别说了诹访子、现在只能依靠你了……」
「無様な所を見せてしまった……この恩は忘れないよ」	「让你看见了我可悲的一面啊……这份恩情我不会忘记的」
「大丈夫だよ早苗、私がついているからね」	「没关系的早苗、因为有我在你身边呢」
『もう何も怖くない！ですね！』	『已经没有什么好怕了！是这样吧！』
「昔を思い出すなぁ諏訪子」	「让我想起了过去的时光啊诹访子」
『あの時は敵だったでしょう！』	『那个时候我们是敌人吧！』
「私を信じるものは救われちゃう……」	「信仰我、你将会得到拯救……」
「よくもまぁ、私の前に顔を出せたものだよ……」	「好大的胆子、居然还敢出现在我的面前……」
「ふふふ、私の力が必要なようだね」	「呵呵呵，看来需要我的力量呢」
「背中は任せた！」	「背后交给我吧！」
「……悪く思うな」	「……别往心里去」
「悪いけど、他人を助けるほどの余裕はないんだ」	「不好意思、现在可没什么余裕去帮助他人啊」
「さぁ、これを飲みなさい」	「来、把这个喝下去」
「ゆっくり…慌てずにな」	「慢慢来…不要着急」
「くっ…！」	「咕…」
「また、植えつけられたのか…」	「又被、播种了吗…」
「……また体に種を……」	「……身体里又被播种了……」
「あいつらの、一部が……あぁぁッ！」	「他们的、一部分……啊啊啊啊！」
「くそぉッ……植えつけられたか！」	「该死……又被种下了吗！」
「あはぁ……	「啊哈……
また、種付けされたゃった	又被、种付了呢
「かにゃこ苗床だ～い好きぃ	「神奈子超～喜欢成为苗床了
「あっ、また	「啊，又能
触手しゃん産めるよ	剩下触手宝宝了
「あはぁ～～ッ	「啊哈～～！
かにゃこの苗床子宮、種付けされて喜んでる	神奈子的苗床子宫、最喜欢被种付啦
「あぁあ…大きくなって……もう嫌あぁ！」	「啊啊啊…又长大了……真是讨厌啊！」
「はあうぅうっ…うぐっ！…動、くなあぁッ！」	「哈啊啊唔唔……唔咕！…不、不要动啊！！」
「ほぉおぉっ……おごおぉっ	「齁哦哦哦……哦齁哦哦哦
おおおぅうんんんっ……	哦哦哦唔唔嗯嗯嗯……
「ふふっ、大きくなってる	「呵呵，变大了呢
「あっ、	「啊、
動いた	动了
「うえううあぁッ…あがっ…動か…ないでぇェッ！」	「唔呃唔哦啊啊啊…啊噶…不要…再动了啊啊啊！」
「へえあぁぁがッ…ああぁん	「呜啊啊啊……啊啊啊……
はぁ……はぁ……	哈……哈……
「はやく…はやく産まれておいで	「快点…快点出生吧
「父上……お助けください！」	「父亲大人……救救我啊！」
「あぁああぁ嫌ぁあ……もう産みたくないぃぃ！」	「啊啊啊啊不要啊……已经不想再生下来了啊！」
「へぶっ	「呃唔嘶
ううぶぅぅぅうッッ	唔噗唔唔唔唔唔哦
「産まれるっもう産まれるうぅ	「要生了、马上要生下来了
出産アクメ待ちきれないよぉぉっ	等不急要出产高潮了哦哦哦
「お゛お゛ぉッ……おごおぉんんぅ	「哦齁哦哦……啊嗯哦哦哦
はやぐ……産みたいよぉぉっ	快一点……想要生下来
「う…、気分が……」	「呃…、感觉……」
「ぐぅうっ……症状が妊娠に似ている……射精なんてされてないのに」	「唔呃……症状像是怀孕了……但是我并没有被射精过啊」
「うっぷっ！…なんだ、この不快感は……」	「呕！……这是什么、这种不快感……」
「はっ…うぅぅっ」	「啊……呕唔唔」
「くそぉっ！……胚を直接植え付けられたというのか……」	「可恶！……这是直接把胚胎植入了吗……」
「えっぅぐ！……これはまさか、悪阻――そんなッ！」	「呕呃呃！……这难道是、妊娠反应——怎么会！」
「ひいぃぅぐぅぅぅぅッッ――」	「噫噫咕唔呜呜唔唔——」
「や…やだぁ……触手なんて産みたくない！化け物の子供なんて産みたくないぃぃっ！！」	「不要…不要啊……我不想生下触手！我不想生怪物的孩子啊！！」
「誰か、助けて…すわこ……さなえぇ……父……上ぇぇ……」	「谁来、谁来帮帮我……诹访子……早苗……父亲……大人啊啊……」
「へうぅぅぐッ……くぅ、また孕んだか……」	「呃呕呕唔……唔、又怀孕了吗……」
「……へぅうぅぐっ……見て分るだろ、孕まされたよ……」	「……呕呃呃……能看出来吧、我已经怀孕了……」
「……力が思ったように入らない……孕んだみたいだな」	「……力量没有办法达到预期……看来像是怀孕了呢」
「あハッ……はははっ、まぁたデキちゃったぁ♪」	「啊哈……哈哈哈，又怀上了呢♪」
「……父上……何故私を、女などに御作りにッ……」	「…父亲大人…为什么、会把我生做一个女人……」
「ううッ…ごめんね……ちゃんと産んであげられなくて……ごめんね……ッ」	「呜…对不起……不能好好地将你生下来……对不起……」
「は…ははっ……堕ろして、やったぞ……」	「哈…哈哈……成功的堕胎了、太好了……」
子宮に着床した子が、もはや手遅れな程に成長してしまった事を悟った神奈子は	在神奈子意识到，子宫里着床的幼体已经成长到无可挽回的地步了。
やがて生まれてくるであろう、わが子に狂気と愛情の入り混じる歪んだ愛着を抱き、腹を愛おしそうに撫でながら微笑んだ。	怀着对即将出生的孩子的狂气母爱，她微笑着、视若珍宝般的抚摸着自己的肚子。
「あはは……はやく、産まれておいで……」	「啊哈哈……快点、降生吧……」
やがて生まれてくるであろう、異形の子に恐怖と不快感を抱き、腹を抱えながら震えた。	怀着对于即将出生的异形之子的恐惧与不适、她紧紧地抱着肚子颤抖着。
「あぁぁあ……今度は、ダメか……」	「啊啊啊……这次、不行了吗……」
神奈子は仲間達に出産が近いことを告げ、産まれた子の名付け親になって欲しいと言ったが	神奈子告诉同伴们、离自己的分娩已经不久了，并希望她们能成为新生儿的教母
少女達は気の毒そうに、何か諦めたように目を伏せ、首を横に振るだけだった……	少女们无奈地低下了头、像是放弃了什么一样、摇了摇头……
「私の子が生まれるんだ……誰か、祝詞をあげておくれよぉ」	「我的孩子要出生了……谁来、为我们献上祝福呢……」
神奈子は陣痛に苦しみながら呪詛の言葉を吐き、仲間にいっそ殺して欲しいと願ったが	神奈子在阵痛的折磨中呢喃着诅咒的话语，甚至期望同伴们能干脆杀掉她。
「後生だから……こんなの嫌だ……嫌なんだよぉっ！」	「要在这种情况下苟活……不要啊……我不要啊！」
「あはぁぁッ……ああぁ……おおぅうぅぐぅうっっ！」	「啊哈啊啊……啊啊啊……齁齁唔哦哦哦哦！」
「は、はやく……出ておいで……私の子！」	「快、快点……出来吧……我的孩子！」
「ううえあがあぁがッ！ひぅうぐうぅぅぅっ！！……」	「呜呜啊嘎啊嘎！咿呜咕呜唔唔哦哦！！……」
「やだ……もう産みたくないぃ……嫌だああああ！！」	「不要……我不要再生了……不要啊啊啊啊！！」
「ひっひっふぅ～～！ひっひっふぅ～～～！」	「噫呼噫哦～～！呃呃呼哦～～～！」
「は、はやく…産みたい！私の子……おっぱいたくさんあげたいぃっ！」	「块、快点……生下来吧！我的孩子……有好多的奶水可以给你们哦！」
「へげあああががっ……あっぁあああ…」	「呃哇啊啊啊……啊啊啊啊……」
「誰か、助け……おねがい……もう……殺して……」	「谁来、救救我……拜托了……已经再也……杀了我吧……！」
「……すまない、少し気分がすぐれないんだ」	「……抱歉，我稍微有点不舒服」
「……気分が悪い…毒でも盛られたか？」	「……感觉有些不舒服…难道是中毒了？」
「…吐き気…微熱…目眩に疲労……腹痛も少し……」	「…恶心…微热…头晕和疲劳……还有少许腹痛……」
「――妊娠の初期兆候？……まさかな」	「——怀孕的初期征兆？……不会吧」
「率直な意見を聞かせてくれ……私は、妊娠していると思うか？」	「想听听率直的意见……你认为我、怀孕了吗？」
「本当に……孕んだのか……私が？！」	「真的吗……怀孕了……我吗？！」
「…うっぐ！……これは、まさか本当に！」	「…呃！……难道说、真的是！」
「……ふ、ふふふ……身重の軍神なんて、絵にならないんだよ」	「……呵、呵呵呵……身怀六甲的军神、还真是不成体统呢」
「……言い逃れするつもりは無い……私は、孕まされたよ」	「……我不打算找什么借口……我、确实怀孕了」
「……孕んだ……この私が……」	「……怀孕了……我居然……」
「私も、女だったという事か……ははっ、ははは……」	「原来我、我也是女人吗……哈哈、哈哈哈……」
神奈子は何処か遠くを見つめながら、壊れたような表情で笑い始めた。	神奈子望着不知何处的远方、带着崩坏的表情笑了起来。
「ぐへぇえあぁッ……くそぉっ！私の中で、暴れている！」	「呕呃呃哦……该死！在吾体内、它在暴动！」
神奈子は陣痛に苦しみもがき、せめて出産の間は見ないでくれと願った。	神奈子在阵痛的折磨中挣扎着、她祈求着别人至少不要看她的分娩过程。
仲間達は気の毒そうに、何か諦めたように目を伏せ、背を向ける事しかできない……	同伴们看起来似乎很同情，就像放弃了什么一样，她们低着头，背向了那令人绝望的场景……
「うぅぅあぁっ……あぁ……出産なんて……化け物を産むなんてぇぇっ！」	「呃呃唔啊啊……啊啊……生孩子什么的……生出怪物的孩子什么的呜呜哦！」
「うぎいっぃいぃ！ひぎいぃぃぃぃぃっ！！……」	「呃啊啊噫噫！啊啊痛噫噫噫噫噫！！......」
「そんなッ！……この私が……誰ともわからぬ子をぉぉッッ…！」	「怎么会如此！……吾居然会……生下一个谁都不知道是什么的孩子…！」
「ううアァァッ……だめ、乳房が……母乳でちゃうぅっ！」	「呜呜啊啊……不行、乳房……母乳流出来了！」
「ひぃっ……胸が張って……まさか……母乳……」	「噫啊……胸部好涨、跟要裂开了一样……难道是……母乳……」
ついに母乳を分泌し始めた自分の乳頭を目にし	终于看到自己开始分泌乳汁的乳头。
自分が“繁殖の為の苗床に過ぎない”という事実を叩きつけられた神奈子は、歯をカタカタと鳴らして顔を青ざめさせた。	意识到了自己“不过是个繁殖用的苗床”这一事实、她紧咬着牙关、脸色苍白
「ふウゥぐっぁぁあ゛っ！……もう、やだ……産みたくない！！」	「呼呜呜啊啊啊！……我不要了……我不想生下来！」
「出て…くるな……嫌ぁ……」	「不要…出来……讨厌……」
「やめてえええぇえあががあがあああぁッッ！！！」	「停下来啊啊啊啊啊噶哦哦哦唔啊啊！！！」
「いぃぃ…嫌あぁ……出てこないでぇッ！」	「不要啊...不要啊……不要出来啊！」
「産みたくない！化け物の子なんて産みたくないぃぃぃっ！」	「我不想生！我不想生怪物的孩子！」
「うぎいぃぃっっ！いやあぁぁああああああッッ！！！」	「呜啊啊啊！不要啊啊啊啊啊！！！」
「ひぃぎゅぅぅ	「啊噫齁呃
うまれうぅぅっ	要生了
またうまれうぅっ	又要生了啊
「しょくしゅにょ、あかちゃんっっ……	「触手的、小宝宝……
「うまれちゃうぅぅ～～～ッッ	「要生出来了哦哦哦～～～
「んひゆぅぅぅぅぁあがっ	「噫唔哦哦哦哦哦哦
うまれりゅっっ	要生出来了哦哦哦
「苗床かにゃこっ	「苗床神奈子
しょくしゅしゃん産みにゃがら	一边生产触手大人的宝宝
産道犯しゃれてイぎゅぅぅっっ	一边在被侵犯着产道高潮了哦哦～～
「んぐぅぅうぅっぁぁあが	「嗯唔唔哦哦哦齁齁齁啊啊啊
「んひぃぃいっ	「嗯噫噫噫
触手授乳らめぇえぇっ	触手授乳不行啊啊啊
「ミルクタンクぶっ壊れるぅっ	「乳袋要坏掉了啊啊
乳射精アクメッッ	乳首射精高潮噢哦哦哦
「バカになっちゃうぅぅぁぁあ゛っ！	「要变成白痴惹齁齁齁哦哦哦哦哦」
「あへえあぁっ	「啊齁齁噶啊啊啊
おっぱいらめぇええっ	胸部不行啊啊啊啊～～
「化け物なんかに、授乳しゃせられてぇっ	「被怪物什么的、强制授乳了噢哦哦
イぎゅぅぅうぅぅ	去惹呃呃呃哦哦哦哦
「うぅぅうぐっ！……ダメ、だ……殺さ…ないとッッ！」	「呜哇哇啊啊啊！……不行、杀……要杀掉…！」
「これ以上、……奴らを増やしては……！」	「这样下去的话、……不能再增加这些家伙了……！」
「……ひぅ	「……咿
おおぉ、んぅ	哦哦哦、嗯
「えへへ……生まれたての触手……	「欸嘿嘿……刚出生的、触手宝宝……
大きくなったら…私を孕ませに来て	长大以后…再来让妈妈怀孕吧……
「ぐはあぁああがっ……ッ」	「啊噢啊啊啊……」
「や……やだぁ……化け物の子なんて……産みたくないいぃっ！」	「不……不要啊……怪物的孩子什么的……我不想生下来啊！」
「いいぎぎいぃっ！嫌っ…嫌あぁあぁっ！」	「不行不行啊！不要……不要啊啊啊！」
「へうぅぅううぅぎいぃ	「唔唔唔唔唔噫噫
「そんにゃ……母乳が出るにゃんてぇ	「怎么会……母乳流出来了这种事情
「やめっ	「停下
やめれぇえっ	停下来啊
ばけもにょなんかにぃ	给那种怪物什么的
おっぱいあげりゅなんてぇぇ	给它喂奶什么的
「ひうぅぃい～	「噫噫哦哦哦～
～～～～～～っ	～～～～～～～～
「殺して…やるっ！……殺してやるぅっ！」	「杀了……混蛋！……我绝对要杀了你！」
「あれは、私の血を……国津神の血を汚したんだ……！」	「那东西、污染了我的血……污染了国津神的血……！」
「んひぃぃぃ～～	「呣噫噫噫～～
うまっれりゅぅっ	生出来了～
苗床しきゅうっ赤ちゃん出していぐゅぅぅぅうっっ	苗床子宫、因为宝宝出产高潮了齁齁齁哦哦哦哦～～
「はひぃっ	「啊噫噫～～
うまれりゅっ	生出来了～
出産アクメいぎゅうぅぅっ	生产高潮去惹齁哦哦哦
「ほごぉぉぉっっ	「高潮齁齁哦哦哦～～
かにゃこ出産しゅきぃぃっ	神奈子出产高潮喜欢～～
子孫繁栄ばんじゃいっ	子孙繁荣万岁齁哦哦
出産絶頂経験＋１～～～ッッ	出产高潮经验+1～～～
「ふウゥぐっぁぁあ゛っ！……やだ……もう産みたくない！！」	「呼唔噶哦哇！……不要……我不想再生了！！」
「出てきちゃ、だめっっ！……嫌ぁ……」	「不能出来、不行～～！……讨厌……」
「産みたくない！こんな所で産みたくないぃぃぃっ！」	「我不想生！我不想在这种地方生下来啊啊啊！」
「ひぃいぅうぅ	「噫呀！
も…らめぇえぇえッ	不要…住手啊啊啊
「らめぇえなのにぃッ	「明明不想要的
おっぱい吸われてっ	胸部被吸着
授乳してッ	这样强制授乳
イっちゃうぅぅぅっ	要高潮惹呃噢哦哦
授乳らめぇえぇっ	授乳不行嗯啊啊啊
「あかちゃんに授乳しゃせられてぇっ	「被婴儿哺乳啦
「これ以上、……呪われ子を……！」	「不能再让、……这被诅咒的孩子……！」
「元気、な……赤ちゃん……	「啊啊、很健康呢……小宝宝……
早く大きくなって…私を孕ませに来て	快点长大吧…再来让妈妈怀孕
「えぎぃぃ…ぅうっ……殺さ、なくては……」	「呃……嗯嗯……杀掉、必须要……」
望まぬお産によって生み落とされた鬼子を、せめて自ら始末しようと、%CALLNAME:(TARGET)%は死に物狂いで手を伸ばすが	为了至少能亲手杀掉这个不期望诞生的怪物之子，%CALLNAME:(TARGET)%手足无措地伸出双手抓住了它。
神の血を半分受け継ぎ、授乳によってたっぷり神奈子の力を奪い取った呪われ子は彼女の手を振り切ると、闇の奥に溶けて行った…。	那个继承了一半神之血，并通过吸取乳汁充分夺走了神奈子力量的诅咒之子，轻易挣开了她的手，消失在了黑暗的深处…。
「うぅひぃっ…！」	「啊好疼…！」
「尻穴に産みつけられたか…？！」	「这是被生产进尻穴中了吗…？！」
「……今度は、腸(ハラワタ)の中にッ……」	「……这次是、在肠道当中……」
「あいつらの、卵が……あぁぁッ！」	「它们的、卵……啊啊啊啊！」
「卵を産まされる……私が？……」	「我居然要……被迫产卵吗？……」
「――くそっ、蛇や蛙じゃないんだよッ！」	「——该死、我又不是蛇或者青蛙！」
また、産み付けされたゃった	又被、强行产卵了
「今度はお尻の穴ぁ～～	「这次轮到尻穴了啊～～
アナル産卵好きぃ	尻穴产卵喜欢～～
かにゃこのケツマンコ、卵抱えて悦んでる	神奈子的肛门小穴、抱卵喜欢～～
「はあうぅうっ…うぐっ！…腹の中で…育ってる…！」	「哈唔唔唔唔…唔咕！…在肚子里…逐渐成长着…！」
内臓で擦れて	摩擦到内脏了
「うえううあぁッ…あがっ…ハラワタが、破れるうぅっっ！」	「啊哇哇啊……啊噶……！内脏要、要裂开了啊！」
「はやく…はやく出ておいで	「快点…快点出来吧
「ひぃぃッ……助けて…父上ぇっ…」	「噫啊啊……救救我…父亲大人啊…」
「あぁああぁ嫌ぁあ……卵なんか、産みたくないぃ！」	「啊啊啊啊啊不要啊……卵什么的、我不想生啊啊！」
産卵アクメ待ちきれないよぉぉっ	产卵高潮等不及了噢哦哦哦哦～
はやぐ……産卵したいよぉぉっ	快点……好想要产卵哦哦哦
アナル卵出していぐゅぅぅぅうっっ	屁股小穴的蛋一个一个生出来好舒服噢哦哦哦～～
産卵ケツアクメいぎゅうぅぅっ	屁股小穴的产卵高潮喜欢齁齁哦哦哦哦～
かにゃこ産卵しゅきぃぃっ	神奈子产卵喜欢嗯噢哦哦～
産卵絶頂経験＋１～～～ッッ	产卵高潮经验+1～～～
「ふウゥぐっぁぁあ゛っ！……やだ……卵なんて産みたくない！！」	「呃呜，咕啊啊啊啊！……不要……我不想产卵啊啊！！」
「産みたくない！産卵なんてダメぇえっ！」	「我不想生啊！产卵这种事情不行啊！」
「あっ…あぁぁ…………私……卵産んで……」	「啊…啊啊啊……我……我在产卵……」
「――へ…蛇みたいに……」	「――呃……像蛇一样……」
「ははっ…あぁっ………あはははッ…うっぅぅぅ……」	「哈哈……啊啊……哈哈哈哈……呜呜呜……」
自身の身体に起こったおぞましい変化に、神奈子は恐怖と絶望の入り混じった、狂気の笑みを浮かべて涙を流した。	面对自己身体发生的可怕变化、恐惧和绝望交织在一起、令神奈子发出了疯狂的笑声、流下了眼泪。
異常極まりない経験により、神奈子は神としてのプライドをへし折られてしまった。	由于极度异常与疯狂的体验，神奈子的神之尊严被彻底摧毁了。
【気丈】【プライド高い】を失った。	失去了【坚强】【自尊心高】。
「ひぃぃぃ？！！」	「噫啊啊啊？！！」
「まさか……胸に産みつけられた…？！」	「难道……胸部被产下了…？！」
「……今度は、乳房の中にまでぇッ……」	「……这次、连乳房里面都……」
「ああぁあ…胸の中に……卵がぁッッ！！」	「啊啊啊啊…在胸部里面…有卵啊啊！？」
「――ああぁ、嫌ぁ……出して……だれか、取り出してぇえ！！」	「——啊啊啊、不要……拿出来……谁来、把它拿出来啊啊！！」
神奈子は半狂乱になって乳房を揉みしだくが	神奈子像是疯了一样、狂乱的揉捏挤压着自己的乳房
その行為は、乳腺の奥底に巣食う卵を転がし、おぞましい異物感を際立たせるだけだった。	但这种行为只能让寄生在乳腺深处的卵滚动起来，更加凸显了那种恶心的异物感。
おっぱいに産み付けされたゃった	胸部里被产卵了啊
「おっぱいで産むなんて、気持ち良さそうだねぇ	「用胸部来产卵的话，感觉似乎会非常舒服呢
「あはぁっ、乳首産卵ん～	「哈哈啊、乳首产卵～
待ち遠しいねぇ	好期待呐～
「あっあぁあッ	「哇啊啊啊呀
かにゃこの淫乱乳袋、卵産みつけられて感じてる	神奈子的淫乱乳袋、被产卵了感觉好厉害啊啊～
神奈子はうっとりとした表情で乳房を揉みしだき	神奈子带着陶醉的表情揉捏着自己的乳房
乳腺の奥底に巣食う卵を転がして、異物感と快感を貪っている。	寄生在乳腺深处的卵不停地滚动着，她贪婪地享受着异物感所带来的强烈快乐。
「あぁあ…胸の中で蠢いて……嫌あぁ！」	「啊啊啊……在胸部里蠕动着……讨厌啊啊！」
「はあうぅうっ…うぐっ！…乳房の中で…育ってる…！」	「啊哈呜呜…呜咕！…在乳房里…正在生长着…！」
「あへえぇあぁっ……あぁんっ	「啊嘿嘿哈啊……啊啊嗯
んうぅうぅううぅ……	嗯呜呜呜呜呜……
「おっぱいの中、卵でこすれてるぅ	「乳房里面、被卵摩擦着
「んいぃっ、	「嗯呀啊
乳腺、卵でこりこりってぇ	乳腺、被卵咕哩咕哩地摩擦着哦哦
「あぁッ…ああぁっ！！…おっぱい嫌あぁあっっ！」	「啊啊…啊啊啊！！…胸部不要啊啊啊！！」
「ひいいぎゅぅッ…ぅうぅん～～	「去惹嗯嗯齁齁齁哦…唔唔嗯……
はぁ……ひぃ……	哈啊……呼啊……
「産む時は…射乳と一緒にかねぇ	「产卵的时候……也一并射乳了……
「あぁぁあッ助けて………父上え゛え゛ぇぇッ！」	「啊啊啊啊救救我啊………父亲大人啊啊啊啊！」
「うわあぁぁあッッ！……胸で卵なんか、産みたくないぃぃぃッッ！」	「呜哇啊啊啊！……乳房里的卵什么的、我不想生下来啊啊啊啊啊！」
「ひぎぅっ	「去惹哦齁齁～
うんんぐうぅぅぅうッッ	嗯咕唔呜呜呜呜齁齁
「おっぱい卵っもうでりゅぅぅッッ	「乳房里的卵要喷出来了噢哦哦
産卵アクメ！ミルク噴射といっしょにイキたいのぉっ	产卵高潮！想在乳汁喷射的时候一起高潮齁哦哦哦哦啊啊～
はやぐ……乳首産卵早ぐぅぅぅっ	快点……乳首想要快点产卵嗯噢哦哦～
「あびぃぃ～～	「啊噫噫噫～～
おおお、おっぱいぃぃ	唔哦哦哦哦、乳袋噫噫噫
おっぱい卵出りゅぅぅぅうっっ	乳袋里的卵要出来啦哦哦哦哦
「い゛ひぃぃい	「噫咿噫噫噫)
おっぱいで卵産んでいぐぅうぅぅ	乳房产卵高潮噢哦齁齁齁齁哦哦～
「へぎゃあぁがっっ	「齁噶啊啊啊噶啊～～
ちくびっ産卵っしゅごぃいｘ	乳头产卵太棒惹齁哦哦哦～～
「ひぃぃいぁぁあ゛っ！……やだ……おっぱいから卵なんてぇえ！！」	「讨厌啊啊啊啊！……不要……从乳房里生蛋什么的！！」
「こんなのっ嫌！……嫌ああぁぁ…ッッ…」	「这种东西不要啊！……不要啊啊啊啊……啊啊……」
「ひぐぅうぁああがあああぁッッ！！！」	「咿咕唔唔啊啊啊噶啊啊啊啊！！！」
「卵なんて産みたくない！乳首でなんて……」	「蛋什么的不想生啊！用乳首什么的……」
「乳首からなんて……いやあぁぁああああああッッ！！！」	「从乳首出来什么的……不要啊啊啊啊啊啊啊啊啊啊！！！」
「だめだ……もう、限……界……」	「不行了……已经、极……限了……」
「――ぁ……意…識が……」	「——啊……意…识要……」
「うぐ……休む時ぐらい、動くんじゃないよっ！」	「唔咕……至少休息的时候、就不要乱动了啊！」
「へうぅっ…うぐうぅっ……身重の上に、見張り無しで寝るのか……」	「唔唔……唔咕……身体好重、没人守夜的时候可以睡觉吗……」
「ぅうッ、目眩がする……」	「唔啊、头好晕……」
「……一人で寝るのは危ないが、倒れてからでは遅いか」	「……虽然一个人睡觉很危险、但如果到倒下的时候就太晚了」
「そろそろ…限界か……」	「差不多…到极限了……」
「今なら一人で寝ても……」	「现在的话，即使是一个人睡觉也……」
「うぅ～ん、早苗の添い寝が恋しいよぉ……」	唔唔～嗯、好想抱着早苗一起睡觉啊……
「すまない、限界だ……」	「抱歉、到极限了……」
「見張りを、頼…………ｚｚｚ」	「请帮我看守一下、拜托了……ZZZ」
「ふうああぁぁっ……先に休むよ……」	「呼啊啊（哈欠）……我先休息一会儿……」
「一時間したら…起こ…し…………ｚｚｚ」	「一个小时后…叫醒…呼…………ZZZ」
「おうぅぐっ…少しだけ、休ませてくれ……」	「哦呕呕唔……稍微、让我休息一下吧……」
「うぅうっ…すまない……こんな体じゃ、休まないともたない……」	「唔呕呕唔……抱歉……这种状态下、不休息的话、我有点撑不下去……」
「ふぁっ……眠いな、少し休もう」	「呼啊啊……好困、稍事休息一下吧」
「そろそろ寝ないとまずいね、交替で見張ろう」	「差不多该睡觉了、不然会有麻烦的、我们轮流看守吧」
「少し休むか、先に寝るといい」	「稍微休息一会儿吧、你先睡会儿也可以」
「何時間かしたら起こすよ、交替で眠ろう」	「过几个小时我会叫醒你的、我们轮流睡吧」
「ふうああぁぁっ……悪いけど、見張りを頼むよ」	「呼啊啊啊（哈欠）……不好意思、麻烦你看守一下了」
「おうぅぐっ……悪いけど、寝ている間見張っていて……」	「呼啊啊啊（哈欠）……不好意思、在我睡觉的期间能帮我看守一下吗……」
「うぅうっ…すまない……頼りにしているよ……」	「唔唔嗯…抱歉……得完全依靠你了……」
「少し寝るから、みててくれない？」	「我需要稍微睡一会儿、能帮我看着点吗？」
「あ…んんんんっっ」	「啊…嗯嗯嗯嗯～～」
「体制を…立て直さないと…」	「必须…重整态势…」
「うぅうぅ……結界も、ろくに張れんとは！」	「呃呜呜……连结界都、没办法好好完成！」
「だめ…だ……眠れる、場所を……」	「不行…了……要找一个、能睡觉的地方……」
「くそ……休める場所をつくらねば…」	「可恶……得赶紧找个休息的地方……」
「このままでは、身体が持たん…はやく休む場所を…」	「这样下去的话、身体会受不了的…得赶紧找个能休息的地方…」
「失せよ、化生共」	「消失吧，外道的怪物们」
「八坂の神風に、なぎ倒されるがいい…」	「就让八坂的神风、将你们全部消灭……」
「……汚らわしい」	「……真是污秽」
「くぅっ！…できるだけ、遠くに！」	「咕！…得尽量到、远一点的地方！」
「はぁっ…ふぅぅっ！…ここに居ては、ダメだ！」	「哈…呼唔！…不能待在、这个地方！」
「すまないね早苗…主柱として恥ずかしいよ」	「抱歉早苗…我现在愧为守矢的主柱、真是耻辱」
「ごめんよ早苗…今の私は足手まといだ……」	「对不起早苗……现在的我是个累赘……」
「おい諏訪子！こちとら手負いなんだ、もう少し歩調をだなぁ…」	「喂诹访子！我这边可是伤员哦、步调能不能稍微慢一点啊…」
『ふん、足手まといは置いてくわよ？』	『哼，累赘我可是会抛弃掉的哟？』
『…ちょっと神奈子、大丈夫なの？』	『…等等神奈子、你没问题吧？』
「祟り神に心配されるとはな……気にせずさっさと走るんだよ！」	「居然被祟神给担心了啊……别在意、快点跑吧」
「ふぅっ…ぐ……今の私は、足手まといか……」	「呼嗯……咕……现在的我、是个累赘吗……」
「わたしは、大丈夫だッ……気にせず先を……ぅッ！」	「我、没事的……继续往前走吧……呜！」
「ハァ…ハァッ……！」	「哈啊……哈啊……！」
「…もう、余裕がないというのに……！」	「……已经、没有什么余裕了……！」
「く……急がなくては！」	「咕……必须赶快！」
「どこかに、休める場所はないか…！」	「哪里有、能让人稍微休息一下的地方呢…！」
「くっ…休みたいが、ここは気が向かん」	「嗯…虽然想休息一下、但在这里没什么心情啊」
「どこかに、安全な場所は……」	「在哪里、有安全的场所呢……」
「『理非なき時は、鼓を鳴らし、攻めて可なり』……」	「『无理之时、鸣鼓而攻之可也』……」
「おっと、『責めて』だったかねぇ？」	「哦多，是在『责备我』是吗？」
「どんどん行くよー！」	「我们快点走吧！」
「うぅ……ぐ……」	「唔……咕……」
「今見付かったら終わりだ……」	「如果被发现的话就完蛋了……」
「んんぅうッッ…	「嗯嗯唔唔唔…
(今は危ないのに…声が出ちゃうぅっ！)	(明明现在很危险…但是声音却忍不住要出来了！)
「ネズミみたいに、コソコソと……『山坂と湖の権化』が無様なものだよ」	「居然像老鼠一样、鬼鬼祟祟的……『	山与湖的化身』还真是狼狈」
「今見付かるわけには……」	「现在绝对不能被发现……」
「ふぐぅぅ……睡眠不足は美容の敵だよ……」	「呼啊啊啊（哈欠）……睡眠不足是美容的敌人呢……」
「石橋は非破壊検査で調べてから渡る主義なの」	「我是渡过石桥前要先进行无损检查主义者呢」
「一寸先は……触手だろうねぇ」	「稍微前方一点……可能是触手吧」
「んっ	「嗯
ぅぅん	唔嗯
「今…触手が来たらぁっ	「现在…如果触手过来的话
「ぅぐっ……何とか隙を……」	「唔咕咕……不管怎样都要找到机会才行……」
「戦況は不利か…」	「战况不利吗…」
「奇襲が上手くいけばいいが…」	「如果奇袭能成功就好了…」
「ぐぅっ！……手負いでなければ、こんな小細工などっ！」	「咕！……如果不是受了伤。这种小把戏根本就……！」
「――――はッ！……伏兵中に転寝とは、不覚……」	「————呼哇！……居然在埋伏的时候睡着了，太大意了……」
「ふふ、伏兵は戦の基本だよねぇ」	「呵呵，伏兵可是战斗的基本呢」
「『孫子』に『ハンニバル』『大長谷王』に『マリアナ沖海戦』もか……」	「『孙子兵法』，『汉尼拔』，『大长谷王』，还有『马里亚纳海战』……」
「くそっ…何か使えるものは……」	「该死…有什么能用的东西吗……」
「このままでは、ジリ貧だぞ…！」	「这样下去的话、情况会越来越糟的…！」
「くぅ……またしても兵糧攻めか……大戦前から何も学ばないよ、日の本は……」	「咕……又是兵粮攻势啊……在大战开始前就什么都没学到、日之本啊……」
「ふぐッ…はぁ…はぁッ…」	「呼咕…哈啊…哈啊…」
消耗の激しい%CALLNAME:(TARGET)%は肩で息をし、探索するのも辛そうな様子だ…。	消耗剧烈的%CALLNAME:(TARGET)%耸动着肩膀喘息着，探索的时候看起来也很吃力…。
「どこかに…眠れる場所は……」	「哪里有…可以睡觉的地方……」
「使えるものは何でも使うぞ」	「用得上的东西即都利用起来吧。」
「正直、こんな気持ち悪い所は漁りたくないけどねぇ……」	「说实话，真不想在这种令人不适的地方找东西……」
「Ｍ２火炎放射器か」	「M2火焰喷射器吗」
「早苗と駐屯地祭に行った時、見たわね……」	「和早苗一起去驻屯地的节日时、看到过呢……」
「早苗がアニメ見ながら叫んでたわね……」	「早苗一边看动画一边大叫……」
「『汚物は、消毒だーー！！』だったかしら」	「『污秽之物、消毒哒——！！』 是这么说的吧」
「早苗が借りてきたホラー映画で使ってたわね」	「早苗借来的恐怖电影中用到过这个吧。」
「『遊星からの物体Ｘ』だったかしら……」	「是『来自游星的物体X（突变第三型）』吧……」
「これで身動きできなくするんだね……」	「用这个就能让身躯无法动弹了吗……」
「――ッ！！べっ、別に…ウットリなんてしてないぞッ！」	「——！！没、没什么……我才没有被这东西迷住！」
「――私だって、マダマダ……」	「——就算是我、也还差得远……」
「――これは…ヒヒイロカネじゃないか！」	「——这不是…绯绯色金的吗！」
「帝のヤツがカキ集めたんじゃなかったのか……」	「难道不是帝那个家伙收集的东西吗……」
「こういう所では、少しでも肌をかくしたいよね」	「在这种个地方、还是尽量隐藏一下肉体比较好呢」
「むっ、これは……」	「嗯、这是……」
「くっ！――この結果も、何時まで保つか……！」	「呼！——这个结界、能保持到什么时候呢……！」
「ひっ、ぐうぅ	「呼、咕
やっと…一息つけるな」	终于…可以稍微休息一下了」
「ふふっ……背中を流してやろう……」	「呵呵……让我帮你搓洗一下背部吧……」
「退けい、化生共！」	「退去吧、外道的怪物！」
「此の地、是より八坂の物なるぞ！」	「这片土地、从此就是八坂之物了！」
「んっふぅ～～～ッ♪後は熱燗があれば言う事ないんだけどねぇ」	「嗯呼～～～～♪如果之后有热清酒的话就再好不过了呢」
「待っていろ、すぐに湯をわかしてやるからな」	「稍微等一下、马上就给你把热水准备好」
「……ふぅ…はぁ…っ」	「……呼嗯……哈啊…」
「生き返ったよ……」	「复活了呢……」
「……疼きが引いていく」	「……痛感逐渐消失了」
「……怪しい泉に裸の美女……Ｂ級映画じゃないんだよ」	「……奇怪的泉水上出现裸体的美女……这可不是在B级电影里啊」
「……んんっ！マズい～～ッ！」	「……嗯嗯！不妙～～呢！」
「もう一杯～～～っ……って古かった？」	「再来一杯～～～……哎呀，这句话成老梗了吗？」
「……ぶふぅぅーーーッッ！！」	「……噗呼呼呼——！！」
「うえええっ…マズ過ぎて眠気が吹っ飛んだよ」	「呃呃呃……太难喝了困意都被吹飞了」
「ひぃいああぁ	「噫咿啊啊啊
にゃ	什
にゃにっ	什么啊
これぇええっ	这个啊啊啊
「からだ	「身体
あつくてぇ	好热
いま、襲われたらぁ～～	现在，如果被袭击了的话～～
「ふおぉぉぉッッ！！」	「呼哦～～～～～!!」
「テンション上がってきたよ！！」	「情绪高涨起来了！！」
「――?!ッ」	「——嗯？！」
「今、何かが……」	「现在、有什么东西……」
「あぁあっっ…嫌あぁぁあ～～っ！」	「啊啊啊……讨厌啊啊啊～～！」
「体の……中にぃぃ～～ッ	「在身体……里面～～～！
「特濃白濁風呂とか怪しすぎるわ！」	「特浓白灼温泉浴也太可疑了！」
「？！しまった！これはスライｍ―――イヒィィッ	「？！不妙！这个是史莱m——咿噫
「おぉぉ…おんっばひらがぁ～～ッ	「哦哦哦……御柱噶哦哦～～～
「ッ……！！」	「嗯哼......！！」
「なんだこれは……まるで恐山の霊泉のようだ！」	「这是什么……简直就像是恐山的灵泉一样！」
「憑き物が取れた……厄神のヤツも放り込んでやりたいね」	「像是把附身的东西除掉了呢……真想把厄神那家伙也扔进去呢」
「石橋を渡るなら非破壊検査してからだ」	「如果要过石桥的话、得先进行无损检测才行呢」
「ひゃぁああんんっ	「噫呃啊啊啊啊
く、くそっ！こんな所で素っ裸とは！」	可、可恶！竟然在这种地方一丝不挂的！」
「ひぃぃっ	「咿呀
くっ、きもちわるい……」	咕、好恶心……」
「早く着替えをみつけなくては…！」	「得赶紧找到衣服换上…！」
「キモッ！」	「恶心！」
「あっち行くんだよ、シッ！シッ！」	「到那边去、嘘！嘘！」
「？………ひぃ！！」	「？......咿噫！！」
「ひいぃいあいぃい	「噫咿咿啊咿咿
りゃめ	不要
らめええぇっ	不要啊啊啊
あひぃぃぃぃっ	啊噫噫噫噫
「うわっ！！くそ……離せ！」	「呜哇！该死……放开我！」
「は、はなせぇ	「放、放开我
あひゅ	啊咿哦
しょこ	那边
やめてぇえぇ	住手啊啊啊
「うわっ！…くそ、油断も隙も……」	「啊！…糟糕、大意了……」
（で、でも、あんなので滅茶苦茶にされたらぁ……	（但、但是、如果被那样的东西弄得一团糟的话……
「――！だ、だめだ！何を考えているんだ、私は！」	「——！不、不对！我在想什么呢！」
「うっ！……くそ、壁に寄りかかる事もできんのか、ここは！」	「呃!……可恶、这鬼地方连靠在墙壁上都有危险吗！」
「うわっ！！？」	「呜哇！！？」
「ひゅあうあぁあ	「呼呀啊噶啊啊
「こにょなか	「这样的话
ぜんぶしょくしゅうぅ	全部触手
めちゃくちゃにぃぃ	搞得一团糟呀啊
「かにゃこの敏感アクメポイントぉ	「神奈子的淫乱敏感点
ぜんぶ	全部
ぜんぶおかしゃてりゅぅぅっ	全部被搞坏了啊啊啊～
「おぉ…あぁ	「哦哦…啊啊
きもぢ…よすぎぃぃ	感觉…太舒服了
「あたまおかしく	「脑子要变得奇怪了
なっちゃあぁあ	变得
んあうああぁあ	嗯唔啊啊啊啊
イグのとまんなぃぃいっ	高潮停不下来了啊啊啊
「くそっ！汚らわしい！触るなあぁ	「可恶！太污秽了！别碰我
ああんんんぅっ	啊啊唔嗯啊嗯
やら	不要
やらあぁあ	不要啊啊啊
「だりぇかぁ	「由谁来
たす…け…ッッ	救...我...呜呜
んぎゅあうああう	嗯唔啊啊啊啊
「あ、危なかった……！」	「啊、真危险……！」
「い、今、捕まっちゃったら、ぐちゃぐちゃに…	「现、现在、如果被抓住的话、会变得一团糟的…
「うっ!けほっ、えほっ！」	「唔哦！咳咳、嗯咳！」
「なんだ、これは……からだが	「这是、什么……我的身体
ああぁあっ	啊啊啊啊啊
あちゅくなってぇっ	变得好热啊啊啊
れきないのぉぉっ	忍耐不了哦哦哦
「ふひぃっ	「呼唔呜唔
こ、こりぇえぇ	这、这个噫噫咿
からだ、疼いてぇえ	身体、在发痛
ああぁあっ、切ないよぉぉっ	啊啊啊啊、好难受呜哦哦哦
「ぐっ！ピンクガスは淫乱だ！」	「呃哇！粉色气体都是淫乱的！」
「持ち主には悪いが、調(みつぎ)と思って有効に使わせてもらおう」	「虽然原主人感到抱歉、但是得作为礼物好好利用起来呢」
「私も余裕がないのでな……」	「我也没有什么余裕了……」
「中東では、ああいうのに火薬を仕込むと言うじゃないか」	「在中东的话、有着那种东西里面会装满火药的说法吧」
「――しまったっ！」	「——糟了！」
「あひぃぃいぎゅぅうぅ	「啊噫咿咿咕哦哦哦
あひゅっ	啊齁
おひり…おひり熱ゅぃいぃ	屁穴…屁穴好热啊啊啊
「んひぃぃぃっ	「嗯哼噫咿咿
かにゃこのっスケベおっぱぃいっ	神奈子的下流乳袋
もっひょ淫ッ乱っ！にぃぃぃっ	变得更淫乱惹嗯齁哦哦哦！
「ほぎょぉぉぉっっ	「齁齁呴哦哦哦哦哦
おぉお、おんっばひら……こ…こわりぇちゃ……ッ	御御御、御柱……要…要坏掉了齁哦哦哦……
神奈子の象徴ともいえるオンバシラは、信管のように敏感に開発されてしまった。	可以说是神奈子象征的雌性御柱、已经被开发的犹如炮弹引信般一触即发的敏感了。
「ぅぅああぁ……あんっ	「唔唔啊啊啊啊……啊嗯嗯
おお、お豆ぇ……痺れが…取れないよぉっ	小小、小豆豆……好麻……好强烈齁哦
「へえあぁ……	「嗬呃呃啊啊……
かにゃこの、お、おまんこぉ…	神奈子的、小、小穴……
こわされ…ちゃったぁ……	要被…弄坏了……
「変態!!　変態!!　変態!!　変態!!」	「变态！！变态！！变态！！变态！！」
「ひぎゅぅああ、らめぇえええぇぇっ	「咿咕唔啊啊啊、不要啊啊啊啊啊啊啊
「おひりにょ穴っ…入らないれぇえぇっ	「屁股上的穴…不要进去啊啊啊啊
んほぉぉぉおぉっっ	嗯齁齁哦哦哦哦啊啊啊
「ひゅぎぃいぃぃッッ	「咿噫噫噫噫啊啊啊
「やぁあぁやめえぇぇっ	「不要不要不要快停下啊啊啊啊
らめっ	不行
らめえぇぇえっっ	不行啊啊啊啊啊
「乳汁吸わないれぇえッッ	「不要吸我的乳汁啊啊啊啊
！！　乳アクメで狂っちゃうのぉぉっ	！！榨乳高潮太强了要疯掉了齁哦哦哦哦
「ひぃぃぃぅぅッッ	「嗬齁哦哦啊啊喔喔
おっぱいらめぇぇえ	胸部不行哦哦哦
「かにゃこ搾っ乳っ！即イきなのぉぉぉっ	「神奈子榨乳！马上要出了啊啊啊啊
「やぁぁやめてぇっ！	「不要啊快停下来啊！
おぉお…おっぱい敏感なのぉぉぉっっ	胸胸…胸部很敏感的啊啊啊啊
「ひぃいぃっ	「噫呀呀呀
あひっ	啊喔
あっあぁぁぁぁんぅっ	啊啊啊啊啊啊啊啊
「お豆っ	「小豆豆
もぅ、だめぇ	要不行了啊
おぎゅううぅ	哦咕唔呜呜
んぐぅぅうあっ	嗯咕呜呜呜啊啊啊
淫蟲の大群は%CALLNAME:(TARGET)%のクリトリスにトドメを刺すべく、	淫虫的大群正对着%CALLNAME:(TARGET)%的阴蒂准备好了最好的一击、
膝を付いて痙攣する%CALLNAME:(TARGET)%の下半身に誘導ホルモンを浴びせ、より大量の仲間と共に一層残虐に蹂躙し始めた。	引导用的荷尔蒙倾泻给了跪在地上的%CALLNAME:(TARGET)%的下半身，更大量的触手群体一起开始了更加残忍地蹂躏。
「んぎっ	「嗯咿
ひぃぅ	嗬唔
うぎぃひ	哇咿噫
もっ、耐えられ	已经、忍耐不了了
にゃいぃ	忍耐不住了啊
「しぬっ	「死了
死んじゃうぅ	要死了齁哦哦
イキ死んじゃうぅぅ	要高潮到死了齁哦哦哦
「へあぁ	「嗬啊
あがっ…あははぁ	啊嘎…啊哈啊啊
おんばひらぁ	御柱
エレクトしちゃいまひたぁ	勃起了、变得勃起了啊啊
%CALLNAME:(TARGET)%の下半身を覆い尽くし、陰核を嬲っていた淫蟲の大群が満足したように解散すると	当覆盖着%CALLNAME:(TARGET)%下半身、疯狂玩弄着她阴蒂的淫虫终于满足地分散离去时
アヘ顔を晒して痙攣する%CALLNAME:(TARGET)%の恥芯は、血管脈打つ男性器のようなオンバシラへと作り変えられていた。	露出啊嘿颜痉挛着的%CALLNAME:(TARGET)%的羞耻阴蒂，变成了血脉卉张不断抽动着的、就像真的男性器一样的、雌御柱。
「んぅうぅぅっ	「嗯呜哦哦哦哦
まんこらめぇぇぇっ	小穴不行啊啊啊
「中で暴れないでぇ	「不要在里面乱动啊啊啊
ひぃぃいぃイぐっ	啊啊啊要去了齁哦哦哦
イキっぱなしでイグぅぅぅうっ	高潮停不下来啊啊啊啊
「…ひぃ…ぃぃ……	「…呜呜…啊啊……
あ、あぁぁ……――？！なに、これ、奥に残って……」	啊、啊啊啊……——？！这是、什么、残留在里面……」
「まさか…植えつけられた……？」	「难道说……被寄生了……？」
「―――ああぁあぁ、もう嫌……嫌あぁあっ！！」	「———啊啊啊啊啊啊、讨厌……讨厌啊啊啊啊！！」
「ぐはっ……！」	「咕哈……！」
「上からくるぞ、気をつけろ！」	「从上面过来了、小心！」
「って早苗の持ってたファミコンで言ってたんだよ」	「这是早苗在家里拿着红白机的时候说的呢」
「ひぎゅっ、らめ…らめぇぇぇっ	「咿咕唔呜、不要…不要啊啊啊
お豆ぃぇいじめにゃいでぇ	请不要欺负小豆豆啊啊啊
「おぉオンばひらァ、大きくなっひゃうからぁあ	「御御柱、被强迫变大了啊啊啊啊
「んほぉぉぉぉお	「嗯齁齁哦哦哦哦
オンバヒラアクメ来りゅ！	雌御柱高潮来啦！
「びゅーびゅー射精でイッちゃぅのぉぉぉっ	「biubiu的雌性射精高潮来啦啊啊啊啊
「けええぃっ！」	「吼呀！」
%CALLNAME:(TARGET)%は一声気合を入れると、自身の陰核に食い込もうとしていた寄生体を力任せに引きちぎった。	%CALLNAME:(TARGET)%大喊一声、气势汹汹地用尽全力将嵌入自己阴核的寄生体拔了出来。
「自販機？……こんな所に？」	「自动售货机？……在这种地方？」
「お代は体で……って事かい？」	「用身体来付款……是这个意思吗？」
「はぁ～…はぁ～～～ッッ	「哈啊～……哈啊～～～
はやくっ、触手服ちょうらいぃっ、もう我慢できにゃいのぉぉ	快点、让我穿上触手服、已经忍耐不了了啊啊
「ううっ、あぁっくそ！……他に着るものはないのかっ」	「呜呜、啊可恶！……没有其他什么可以穿的东西吗」
（……なんで私は、これを着せられる事を期待しているんだ	（……为什么、我会对穿上这个这么期待呢
「……うぅーん、他に着るものもないし……」	「……唔嗯、也没有其他可以穿的东西了……」
「そ、そうだ…他に手はないんだ」	「是、是的…没有其他办法了」
「え、っちょ！それは服なんかじゃ…」	「欸、等一下！这不是衣服…！」
「……よ、よせ……やめろおっ！！」	「……等、等下……住手啊！！」
「ひいぃぃやあぁぁああんんっ	「咿噫噫啊啊啊啊啊啊
「へえあぁ…	「嗬呃啊啊…
あひぃっ…	啊咿…
これ…これだよぉぉっ	这个…就是这个啊啊
「はぁ～	「嗬啊～
あは、だめ…なのにぃい	啊哈、明明…不可以的
気持ちよすぎて……立ってられにゃいよぉ	太舒服了……站不住了啊
「ひんっ	「咿嗯
あぁ…あぁああ……これ、内側が…」	啊啊…啊啊啊啊……这个、里面是…」
「！！――ひいんぅっ	「！！——噫噫嗯唔
ううっっ…動、くなあぁ……」	呜呜…动、不了啊啊……」
「ふうぐぉぉおぉが	「呼呜齁齁哦哦哦啊
か、かにゃこの子宮こじあけて…	把、把神奈子的子宫撞开…
奥までっ！どぴゅどぴゅ注がれてるよぉぉ	到最里面了！嘟biu嘟biu的被灌满了啊啊啊啊
「ふぐぅああぁあ？！やめ、やめてええぇえ！」	「呼咕啊啊啊啊？！停、停下啊啊啊啊啊！」
「なかは…膣内(なか)はダｍ……	「里面…子宫里面是不彳……
―――――――　ドッビュっ！　――――――	―――――――　嘟biu嘟biu！　――――――
「―――っうわア゛ァ゛ア゛ぁあああああっっ！！」	「———呜哇啊啊啊啊啊啊啊啊啊啊啊啊！！」
はひぃぃっ	哈咿呀
「かにゃこのお腹あぁ…しょくしゅしゃんに征服されひゃいまひたぁ	「神奈子的肚子啊啊…已经被触手大人彻底征服了啊啊啊啊
「おおぉご…おふぁぁあがッ」	「哦哦哦齁哦…哦呼啊啊噶」
「も…やめ……膣内射精(なかだし)……ゆるひて……」	「不…住手……腔内射精……放过我吧……」
「おごおぉ！！？ おぶぅっ！ おぉっ、んぉおっ…	「哦哦哦！！？哦哦啵！噢哦、嗯噢哦哦…
んぉっ	嗯哦
…おごぉおっ	…哦齁哦哦哦
こ、これは……	这、这是……
しまった！あぁぁぁあ	糟了！啊啊啊啊啊
これ媚薬……	这是媚药……
身体が疼いてぇ	身体好疼
「女は度胸」	「女人要有勇气」
「何でも試してみるものさ…」	「什么都要试试看嘛…」
「わ、私は嫌だよ！」	「我、我不要！」
「遠慮しないで行って来るんだよ！」	「不要犹豫的去吧！」
「ふぎょぉぉおんっ…おぉぉおしりっ	「呼啊啊啊啊…屁、屁股啊啊啊
おひりぃぃ	屁股
おひり熱ゅいぃぃいっ	屁股好热啊啊啊
「かにゃっこの、ウンチ穴あぁっ	「神奈子的、肛门小穴啊啊
焼けるみたいにぃ	像是烧起来一样
どんどん気持ちよくなるよほぉぉっ	变得越来越舒服了哦齁哦哦哦
「ひいぃあぁあっっ	「咿噫啊啊啊啊
おっぱいっっ	胸部啊啊啊
おっぱいらめえぇえぇっ	胸部不行啊啊啊啊
「かにゃこおっぱいっっ	「神奈子的淫乱乳袋～～
弱いのにぃぃ	明明很弱哦
もっと、敏っ感にぃぃ	变得、更敏感了啊啊啊
おおんばひら虐めらめえぇ	不要虐待我的雌御柱啊啊啊
敏っ感しゅぎて、破裂しちゃうぅぅうっ	太敏感了、要裂开了啊啊啊啊
「ふひぃぃっ	「呼咿噫噫
クリっ	阴蒂
クリトリスらめぇえっ	阴蒂不行噢哦哦
お豆、虐めたらぁぁあ	小豆豆、被虐待了啊啊啊
す、すぐイッっちゃうぅぅ	马、马上就要高潮了啊啊啊
「あひぃぃっ	「啊咿噫噫噫
神奈子のっメス穴っ！	神奈子的母畜小穴！
また、敏感にぃぃっ	又、变得更敏感了啊啊
んひぃぃいいぃっ	嗯咿噫噫噫噫噫
「んぎぃいぃぃ！	「嗯咿噫噫噫！
おっぱい絞り強すぎぃぃっ！	胸部挤压得太紧了哦哦！
「なくなっちゃうぅ！	「会消失的呜哦哦！
ミルクなくなっちゃぅぅぅっ	乳袋要没有了呜呜哦哦
りゃめぇぇぇ～～っ	不要啊啊啊～～
「ンンンーーっっ！！！	「嗯嗯嗯——！！！
んぎぃぃぃ―――――！！！！」	嗯唧咿噫―――――！！！！」
「ぁぁあ…がはぁ……あ、あれ？…身体が……」	「啊啊啊……咳啊……啊、啊咧？…身体……」
「まさか、信仰を奪われて……そんなバカな！！！」	「难道说、信仰被夺走了……这怎么可能！！！」
%CALLNAME:(TARGET)%は小さくなった手のひらで全身をペタペタ確認しながら喚いた。	%CALLNAME:(TARGET)%用变小的手掌拍打着全身，一边确认一边大声惊叫着。
「んほぉぉおぉぉっ	「嗯齁哦哦哦哦
く、クリ…気持ちよすぎてぇ	阴、阴蒂…太舒服了
爆発しちゃぅぅっ	要爆发了啊啊啊
「あぁあっらめ	「啊啊啊不行啊
おんばひら…えれくてっとしちゃうのぉぉ	雌御柱…勃起得跟要裂开了一样啊啊
ふぎょぉぉぉぉぉおっ	呼齁齁哦哦哦哦哦啊
「怪しすぎるだろうが！」	「这也太刻意了吧！」
「へあぁあがががぁが	「嗬啊啊啊咕啊啊啊咕
おおぉぉっおちんぽ穴ぁあ	啊啊啊啊啊～鸡巴上的小穴啊啊啊
「逆っっ流してぇえ	「倒灌进来啦啊啊
おんばひらにぃぃ	雌御柱呜噢哦
どっくどくはいってくりゅうぅ	被不断地灌进去了啊啊啊啊
「あぁ、あひぃぃ	「啊啊、啊啊咿噫
おんばひら……	雌御柱……
ますます、ギンギンになっちゃったよぉ	变得越来越、硬邦邦了啊啊
「ひうぅうぅぅぅっ	「咿呜呜唔唔哦哦哦
や、やめでえ゛ぇええっ	停、停下来啊啊啊啊
ミルク吸い尽くされちゃうぅぅう！！	奶水要被吸干了啊啊啊啊
おっぱい壊れちゃうぅぅぅうっ	胸部要坏掉了啊啊啊啊
「あぁぁが	「啊啊啊啊
へげ	嗬喔
おぉ、んんうぅ	嗯哦、嗯齁齁
母乳を絞り尽くされた%CALLNAME:(TARGET)%は、みっともないアヘ顔を晒しながら痙攣している。	被榨干了母乳的%CALLNAME:(TARGET)%、一边露出了丑陋的阿黑颜一边浑身抽搐地痉挛着
「風呂って……これはザーメンじゃないか！」	「浴池……这不是精液吗？！」
「こんなものに入るわけ――ひぃ！？」	「怎么可能进入这种东西里洗澡——咿噫？！」
やめぇえ	住手
ひいぃあぁっ	快住手啊啊
きもちわるぃぃぃ	好恶心啊啊啊
だりぇか、たすけてぇえっ	谁来、救救我噢哦啊啊
「こ、こにょざーめんっ	「这、这液体是什么
媚薬が……あひいぃい	媚药吗……啊咿噫噫噫
うウゥ疼く、アソコ疼くよおぉっ	啊啊好疼、那里好想要啊啊啊
「赤いリボン……まさか」	「红色的缎带……难道说」
「麓の巫女までもが……」	「山脚的巫女竟然也……」
「この帽子は、白黒の魔法使い！」	「这顶帽子、黑白的魔法使！」
「ダメ……か……」	「已经……不行了吗……」
「うぅ……そんな……この髪飾りは……」	「这……怎么可能……这个发饰是……」
「ああぁああああウソだウソだ！！！早苗が死ぬはずが……」	啊啊啊啊啊骗人、骗人的！！！早苗不可能会死……」
「……そ、そうだ……奴らはスグには殺さない」	「……对、对了……它们不会立刻把人杀掉」
「まだ、望みはある！」	「还、还有希望！」
「ば、バカな……この帽子！！」	「怎、怎么可能……这顶帽子！！」
「あの祟り神が……諏訪子が……ありえん！」	「那个祟神……諏訪子……不可能！」
「この帽子…！八雲の……スキマ妖怪までもが……」	「这顶帽子…！属于八云的……连隙间的妖怪也……」
「幻想郷は一体どうなるのだ」	「幻想乡到底会变成什么样……」
「この帽子……是非曲直庁のッ？！」	「这顶帽子……难道是是非曲直厅的？！」
「バカな！…閻魔までもが堕ちたというのか？！」	「不可能！…难道说连阎魔也沦陷了吗？！」
「これは数珠か……」	「这些、是念珠吗……」
「まさか、命連寺の坊主まで」	「不会吧，连命连寺的僧人也……」
「他にも犠牲者が……くっ」	「还有其他的受害者……唔」
「さっさと解決しなくては、信仰獲得どころの話ではないぞ」	「必须尽快解决，现在不是去争取信仰的时候……」
神奈子の戦闘関係の素質を強化できます（※バランス調整の為ステータスが弱体化します）	可以强化神奈子的战斗素质（※作为调整，状态将被弱体化）
[0] 素質変化無し	[0] 素质不变
[1] [剣術習熟]習得　　　※ＨＰ・ＥＰ最大値が減少	[1][剑术熟练]掌握　※HP·EP最大值减少
「不覚……これではミイラ取りがミイラだぞ」	「失策……这样下去就是捉鬼的人反被鬼捉了。」
ここ最近、幻想郷で多発する失踪事件。	近来，在幻想乡发生了许多失踪事件。
一般の人間のみならず、ある程度実力のある人妖までもが被害に会い始め、いよいよ新たな異変として認められた。	不仅仅是普通人，即使是有一定实力的妖怪也会受害，这终于被认为是新的异变。
それを信仰獲得の好機と捉えた、守矢神社の主柱「神奈子」は	将这视为获得信仰的好机会，守矢神社的主柱「神奈子」、
もう一人の主柱「諏訪子」、そして風祝「早苗」を引きつれて異変解決に乗り出した。	另一位主柱「诹访子」，以及风祝「早苗」开始解决这个异变。
失踪者達の足跡を辿るうち、異常な瘴気を発している洞穴を見つけた三人は、息巻いて中に突入したのだが……	在追踪失踪者的脚印时，三人找到了一个释放出异常瘴气的洞穴，她们气势汹汹地突入进去……
結果は惨憺たるものであった。	但结果却惨不忍睹。
まるで、三人を待ち構えていたかのように、突然湧き出した異形の群れに襲撃され、彼女達は散り散りになってしまう。	仿佛是在刻意等待她们一样，她们被突然出现的异形群体袭击，被迫四散分离。
「三人揃って餌箱の中とは、我ながら無様なものだよ！」	「三人一起成为箱中的饵食，吾这是何等的失态！」
神社の風祝「早苗」を引きつれて異変解決に乗り出した。	神社的风祝「早苗」开始解决这个异变。
失踪者達の足跡を辿るうち、異常な瘴気を発している洞穴を見つけた二人は、息巻いて中に突入したのだが……	在追踪失踪者的脚印时，二人找到了一个释放出异常瘴气的洞穴，她们气势汹汹地突入进去……
まるで二人を待ち構えていたかのように、突然湧き出した異形の群れに襲撃され、彼女達は離れ離れになってしまう。	仿佛是在刻意等待她们一样，她们被突然出现的异形群体袭击，被迫四散分离。
「……早苗と二人っきりで行動したのは迂闊だったか……祟り神のヤツもつれてくるべきだった」	「只和早苗两个人行动可能太轻率了……应该带上祟神那家伙的……」
もう一人の主柱「諏訪子」と共に異変解決に乗り出した。	另一位主柱「诹访子」开始解决这个异变。
まるで二柱を待ち構えていたかのように、突然湧き出した異形の群れに襲撃され、彼女達は離れ離れになってしまう。	仿佛是在刻意等待她们一样，她们被突然出现的异形群体袭击，被迫四散分离。
「二柱揃って餌箱の中とは……危険とみて早苗を留守番に置いたのは、まずかったか……」	「二柱都成为了饵食……因为危险让早苗留在家里可能是个错误……」
神社に残してきたもう一柱の神「諏訪子」や、風祝「早苗」の止めるのも聞かず、異変解決に飛び出していった。	尽管神社里的另一位柱「诹访子」和风祝「早苗」劝阻，但她还是未听劝告，决定独自解决异变而飞了出来。
失踪者達の足跡を辿るうち、異常な瘴気を発している洞穴を見つけた神奈子は、息巻いて中に突入したのだが……	在追踪失踪者的足迹时，神奈子发现了一个散发出异常瘴气的洞穴，并气势汹汹地冲了进去，但……
まるで神奈子を待ち構えていたかのように、突然湧き出した異形の群れに襲撃され、彼女は追い詰められてしまう。	就像是在刻意等待神奈子一般，突然涌出的异形群体伏击了她，将她逼入了绝境。
「我ながら迂闊！……敵の戦力を見誤ったわ」	「吾太大意了！……居然误判了敌人的战力……」
触手宮を満たす禍々しい瘴気は、神奈子ら神にとって頗る相性が悪いようだ。	充斥于触手宫的凶恶瘴气，对于神奈子和其他神来说似乎相性相当的差。
「普段なら巣穴ごと吹き飛ばしてやれる所なのに……」	「如果在平时的话轻松的就能将整个巢穴都打飞了……」
形状大きさ様々な、グロテスクな色彩の触手生物達が、粘液をぬたつかせながら、ゆっくりと神奈子に這い寄って来る。	形态、大小各异的、带有怪异色彩的触手生物，滴着粘液，慢慢地爬向神奈子。
奴らの目的は、単純明快―――	它们的目的，简单明了——
神奈子のグラマラスな肢体を絡めとり、張りの良い美肌を汚濁で穢し尽くし、	缠绕神奈子的妩媚肢体，将她那紧致的美丽肌肤染上污秽、
豊かな胸の双丘を締め絞り、穴と言う穴を犯し尽くし	勒紧她那丰满的胸部，侵犯她身体的每一个可被称为穴的部位，
その体に宿った膨大な神徳の霊力を、体液と共に全て吸い尽くすつもりなのだ……。	吸取她体内那巨大的神力，连同体液一并吸干……
「かといって、この体を好き勝手させるつもりはないけどね」	「虽然如此，但吾并不打算任你们摆布吾的肉体。」
「来るがいい化生共……神の荒ぶる御霊を味わわせてくれよう」	「来吧丑陋的异形们，让你们感受下神明狂暴的力量与威严！」
神奈子の放った色鮮やかな弾幕が	神奈子发射了五彩斑斓的弹幕、
先陣を切っていた触手をボロ雑巾の様に引き裂き、跡形もなく蒸発させた……	将冲在最前面的触手像破布一样撕裂、让它们无影无踪地蒸发了……
「しまったっ！これは触手――	「糟了！这是触手——
ひぃいぃぃ～～ッッ	咿噫啊啊啊～～～～
「――助けてぇ！誰か取って！お願いコレ外してぇーーッッ！！」	「——救救我！谁来帮我、把这个拿掉！拜托把这个东西拿掉啊——！！」
「おのれぇっ！負けるか、この――ッ	「可恶啊！我才不会输，这个――！
「触手なんかに、絶対負けな――ッ	「怎么可能会输给触手这种东西啊——
んひゃあぁああぃいぃ	呀哈啊啊啊咿噫
「ほへぁあぁ	「齁嗬啊啊啊啊
あひゃぁぁあひいいぃぃ	啊咿啊啊啊啊齁咿噫噫噫噫
「りゃめっ！りゃめぇぇえっ	「不行！不行啊啊啊！
おお、おひりぃいりゃめぇえ	屁、屁股那边不行啊啊啊
「んひょぉおほぉぉぉ	「嗯齁哦哦哦哦哦哦
おおぉぉおひりいぃぃっっ	啊啊啊啊啊屁股啊啊啊
「んにゃア゛ア゛アァァ	「嗯呀啊啊啊啊
かにゃこおっぱいぃぃりゃめなのぉぉぉっ	神奈子的胸部不行啊啊啊啊啊
「ひぎゅぅぅぐおっぱいぃぃ	「咿咕唔唔噢哦齁哦哦胸部啊啊
おっぱい虐めにゃいでぇえぇ	不要这样欺负胸部啊啊啊啊
「んんんぁぁぁあぅ	「嗯嗯嗯啊啊啊啊
クリッ！クリトリしゅ壊れちゃうぅぅ	阴蒂！阴蒂要坏掉了啊啊啊啊啊
「ほええあぁぁぁお豆ぇえぇ	「嗬齁呃哦啊啊啊啊小豆豆啊啊啊
かにゃこのお豆破裂しちゃううぅ	神奈子的小豆豆要坏掉了啊啊啊
%CALLNAME:(TARGET)%の醜く開発されてしまったオンバシラを、無数の触手が容赦なく蹂躙する！	无数的触手无情的蹂躏着%CALLNAME:(TARGET)%那丑陋的被开发了的“御柱”！
血管を浮かび上がらせビクビクと痙攣する、身の丈にも及ぶ巨大な竿は幾本もの触手によって、まるでボンレスハムのように、扱き縛り上げられ	几乎一人长的巨大肉竿上青筋浮现、不住地颤抖痉挛、像无骨的火腿一样、几根触手将其束缚起来不断地拍打摩擦、
その付け根にぶら下がる、煮え滾る粥のような本番汁を蓄えた巨大な睾丸まで、口の付いた触手でシャブられている。	挂在巨大肉根下方、像是装满了煮沸的粥一样浓稠精液的巨大睾丸、也被长着嘴的触手不断地吮吸着。
「ふぎょぉあおおぉああ	「呼齁哦哦哦啊啊啊
おぉおっっおんばひらりゃめぇえぇ	哦哦哦哦雌御柱不行齁齁啊啊啊啊
「んえああぁあぁぎいぃぃ	「唔啊啊啊啊啊齁哦哦哦
かにゃこ雌竿敏感にゃのぉぉぉ	神奈子的雌肉棒很敏感的齁哦哦哦哦
「ぐひぃぃぃぎいっ	「咕咿噫噫噫噫噫噫
おおっおまんこりゃめてえぇえ	小穴、小穴不行啊啊啊啊
「りゃめえぇえぇ！おまんこぉぉっ	「快停下啊啊啊！小穴哦哦哦
雌っ穴あぁぶっ壊れちゃうぅぅぅっ	雌穴要坏掉了啊啊啊啊啊啊啊啊
「だめっ！だめぇぇ全部一編になんて無理ぃぃぃっ！！」	「不要！不要啊全部合在一起来不行的啊啊啊啊啊！！」
「ふぎいぁぁあがああっ	「呼咿呀啊啊啊齁啊啊啊
！！　んひっっ	！！嗯咿噫
あヒィィィッッ	啊齁咿噫噫噫噫噫
「んぎゅぅううぐぅ	「嗯咕呜唔唔唔唔咕唔
うぅぎひぃぃ	呜噗咿噫
あ゛ぁあっんああぁあぁっっ	啊啊啊嗯齁啊啊啊啊啊
「んぎひぃ	「嗯咿噫
ひっ…あひぃぃッ	啊……啊啊啊…
ご、ごめんにゃ、しゃいぃぃ	十分、对、对不、不起咿噫
「も…しゃからいましぇんからぁ	「已经…够了、不要再来了、已经受不了了
これ以ッ…上……イぐのぉ	这样……下去的话……又要、高潮了
許ひて、くりゃひゃいぃ……」	原谅我、请原谅我啊啊……」
「おのれ…おのれぇぇ！……こんな、ふざけた罠なんかにぃっ！」	「可恶…可恶啊啊啊！……居然、被这种白痴一样的陷阱困住！」
神奈子は生地の内側で蠢く触手の感触に震えつつ、それに屈した自分の不甲斐なさを歯噛みしている。	神奈子因为布料内侧那些蠕动的触手而颤抖着、咬着牙不得不承认自己的无能为力、只能就此屈服了
「アアッ！」	「啊啊！」
「うぎゃぁああがッッ」	「呜哇啊啊啊啊噶啊啊」
「やめ、アアア゛ア゛ァッ」	「停、啊啊啊啊啊！」
「ひぐぁあぁがあああ！！」	「咿咕啊哈啊啊啊啊！！」
「……ぜぇ…ハァ……ひぃ、ぅぅ…」	「……呃……呼……咿、呜唔…」
「ふぎゃあぁあああがああぁ！！！あひいィィィ―――ッッ！！」	「呼呀啊啊啊啊啊齁啊啊啊！！！啊咿噫噫噫——！！」
「―――ヒッ……ァ゛おっ…」	「———噫啊……啊齁啊啊…」
「おお゛ぉん゛ッ……んご、ぅ……」	「哦哦呃齁唔……嗯哦、呜……」
「ほぎぃっ	「嗬齁哦哦
きもちっ…きぼちぃいぃっ！	好舒服…感觉好舒服哦哦哦！
もっとおっぱい犯してぇぇっ	再更多的侵犯我的淫乱乳房
「かにゃこの淫乱おっぱいマンコ	「神奈子的淫乱乳袋小穴
中にぃっ！一杯種付けしてぇ	射在里面！把我灌满啊啊
乳房妊娠しゃしぇてくりゃしゃいぃぃっ	请让我的雌畜乳穴怀孕吧啊啊啊啊啊啊
「はひぃぃっ	「哈咿噫噫
おおっおっぱい姦しゅごぃのぉっ！	乳房、乳房被侵犯太舒服了！
「神奈子の乳首っ奥まで入っちゃってるよぉ	「神奈子的乳穴被贯穿到最深处了齁哦哦哦
ほごぉっ！中で動いてるのっ！おっぱい穿られていぐぅぅぅっ！	嗬齁齁齁！在里面抽插着！乳穴贯穿高潮来惹呃齁哦哦哦！
「ほぎぃぃっ！やめ…やめてぇぇ	「齁咿噫！住手…住手啊啊啊
おっぱいレイプ許してぇぇっ！	胸部强奸不行、放过我啊啊啊啊！
こりぇぇ、癖ににゃっちゃうよぉぉ	这样啊啊、这样下去会上瘾的啊啊啊
「――ひあぁあっ？！やめっ、そんな所に入るなッッ！！」	「——咿啊啊啊？！住手，那种地方不能进去啊！！」
「あぎぃぃっ？！乳房の中で動いて……嫌あぁぁああっ！」	「啊咿噫噫唔？！在乳房里动起来了……讨厌啊啊啊啊！」
「かにゃこのドＭおっぱいマンコ	「神奈子的抖M淫乳小穴
中でぐじゅぐじゅかき回してぇ	在里面咕啾咕啾的来回搅动
乳房破壊してくりゃしゃぃぃっ	把我的淫乱乳袋弄坏掉吧啊啊啊啊
