「ほっ	「齁
ほひぃぃぃっ	齁齁咿噫噫
しゃしぇいしゅごぃのぉぉ	射精太苏胡惹齁哦哦噢哦
オナバカかにゃこの射精ショー……無料公開実施中ーーーぅッ！」	自慰母猪神奈子的射精秀—……现在免费公开进行中———齁哦！」
とまんにゃい！ザー汁噴射とまんにゃぃぃいっ！……」	停不下来！种汁喷射停不下来啊啊啊啊啊！……」
「んっほぉおぉぉっ！！オンバシラ射精バカににゃるのぉぉ	「嗯齁齁齁齁哦哦！！变成御柱射精成瘾的白痴母猪了哦哦哦
（うぐっあ、我慢……できないぃっ！）	（唔咕啊啊、忍耐……不住了！）
「出るッ……でるぅ！射精しちゃッ……	「出来……出来了！射精了啊……
「んあぁああっ！だめぇっ…オンバシラ…でちゃうぅぅ	「唔啊啊啊！不行太刺激了…御柱…要出来了唔哦哦
「――っくはぁぁッッ！　……く…こんな、所で射精とは……不覚っ！」	「——咕哇啊啊！……在、在这种地方、射精了……太失策了！」
「んっ、くぅぅ……ひっ！	「嗯、咕唔唔……噫！
はやく…済ませてっ！落ち着かせなくては……！」	快点……处理掉！得赶紧冷静下来……！」
神奈子は顔を白目を剥きながら亀頭を抑え射精を止めようとするが、	神奈子一边翻着白眼露出了丢人的阿黑颜、一边紧紧地抓住龟头想要抑制射精、
決壊したザーメンの濁流は、指の間から易々と噴出してしまった……	决堤的精液浊流轻而易举的就从指尖的缝隙里喷了出来……
「ぐひぃっ！あぁ……ダメッ！…射精だめぇっ！！」	「咕咿噫！啊啊……不行！……射精不行啊啊！！」
――――どびゅっ！　ブシュゥゥゥッ！！！――――	――――嘟biu！噗咻咻咻！！――――
「―――ふぎぃぃあああがア゛ア゛ァァァッッ……！！！	「———呼咿噫啊啊啊啊齁哦哦哦哦哦哦……！
暗闇に神奈子の悲鳴と、破裂したような射精音が木霊する……。	在黑暗中回响着神奈子的悲鸣声和像爆裂一样的射精声……。
胴回り程もある黒光りする“超根”は、その根元にぶら下がる二つの巨大な欲望の淫玉から常に湧き出す	腰围大小的、闪烁着黑色光芒的"超根"、欲望正在从其根部悬挂着的两颗巨大的淫乱睾丸中不断涌出
熱い滾りを堰き止める事などできず、絶頂と共に凄まじい濁流となって、神奈子のオンバシラを内側から抉るように噴出する。	炙热的涌流无法被阻挡、伴随着高潮而来的猛烈精液浊流，像是要从内部彻底掏空神奈子一般、从神奈子的御柱当中剧烈地喷射出来。
まるで固形物のように“重い”ザーメンの塊は、噴出した後も滴り落ちる事なく、射晴した神奈子自身にベットリこびり付いた。	仿佛固体一样"沉重"的浓稠精液块、即使喷射出来后也没有滴落，而是牢牢地粘在了射精后的神奈子自己身上。
辺り一面に広がるザーメンゼリーの中で溺れるように、神加奈子は白目を剥いて痙攣し、脱力したまま横たわっていた。	被周围大片大片凝胶一样的精液覆盖着，神奈子仿佛溺水般地陷入其中、眼珠翻白不停地抽搐着、脱力地躺在那里。
「―――へうぶぅうぁぎゃあぁあああっぁ！！！	「―――嗬唔噗齁齁齁哦哦哦啊啊啊啊啊！！！
両腕で抱える程に竿を肥大化させられ、幾らでも射精するよう感度の制限を破壊され、煮え立つ白いマグマを	雌竿被强制肥大化到了两臂合抱的程度、也被破坏了射精的敏感度限制、让它能够随时喷涌射精、
常に精製し続ける醜く膨れ上がった睾丸を移植された神奈子のオンバシラが、まるで爆ぜるように脈動した。	睾丸也被被强行改造成了一副不断精炼着沸腾白色岩浆、恶心鼓胀的淫乱模样、不断喷涌的欲望让神奈子的雌竿像是要爆炸一样止不住悸动抽搐着。
信管のように鋭敏化したオンバシラの快感神経が暴走し、神奈子の全身を焼き尽くすようなアクメが襲う。	变得像引信一样敏感的雌性御柱的快乐神经在这样的刺激下已经彻底暴走、无止尽的快感吞没神奈子的全身、仿佛要将其焚烧殆尽。
常識を超える膨大な射精と共に、神奈子は背骨を折らん程に仰け反りながら、白目を剥いてひっくり返った。	伴随着超乎常识的膨大射精、神奈子吐着舌头翻着白眼、以像是要将脊椎折断一样的力度向上挺起了腰、
黒光りする亀頭から噴出した特濃精液は天井に叩き付けられると、下でノビている射精者自身の上にドチャッと落下した。	从黑的发亮的龟头中喷射出来的超浓稠精液打在了天花板上，然后又哗啦一声地落回到了射精者自己身上、将其覆盖在了浓稠腥臭的精液沼泽中。
「へっぐぅ…んふぅ～	「齁咕咕嗯嗯…嗯呼哦～
へひぃッ……	嗬咿……
ようやく具現を解除する事に成功した神奈子は、尚も疼き続ける陰核を両手で押さえ、ふやけた表情で喘いでいる。	终于成功解除了扶她具现的神奈子、揣着粗气用双手捂住仍然抽痛的阴核、脸上显露出了沉重的疲惫。
「――あッ…んうぅ……ぐふっ」	「——啊…嗯哼…咕唔」
「くぅ！…自分のオンバシラに振り回されるとは！」	「「啊！…居然被自己的“御柱”给操控得团团转！」
「くっ…はぁっ……んんぅ……やっと、おさまったか……」	「呜……哈啊……嗯嗯……终于、平静下来了吗……」
（はぁ～～ッ…あぁ、だめ！…オンバシラ疼いちゃうぅっっ）	（哈啊～～…啊啊、不行！…御柱好疼啊啊）
「あっ、ァア゛ア゛ぁぁっ…今、エクスパンデッドだめぇ	「啊，啊啊啊……现在、变大不行啊啊啊啊
「ひくっ！くそ、またオンバシラが……勝手にぃ～～ッ」	「咿噫！该死、御柱又……擅自的～～～」
「へあぁあぁ	「齁啊啊啊啊。
あひぃぃぃっ	啊咿噫噫噫噫
「あははぁ	「啊哈哈
オンバシラ……戻らなくなっちゃったぁ	御柱……已经变不回去了啊啊
去り際、幽香は相手の触手を盛大に踏みつけていった。	在离开的时候，神奈子狠狠地将对方的触手踩在了地上。
「散々っぱら身体を弄り倒しておいて『ハイ、サヨウナラ』……とか、ないよねぇ？」	「擅自把人家的身体折腾得那么厉害、然后就这样说『好了、再见哟』…这种事想也是不可能的、对吧？」
「んひぃぃ～～ッッ	「嗯咿噫噫～～～～
もっと	更多
もっとザー汁ちょうだいっ！！」	再给我更多种汁吧！！」
「かにゃこのエロ子宮、ダボダボ注いで孕ませてぇ～～ッ	「神奈子的淫乱子宫，满满得灌进去让我怀孕吧啊啊～～
「んふぅ～～っ、どうだ私の胸はぁ……ロリ体型の蛙じゃ無理だろうからねぇ」	「嗯哼～～怎么样、我的胸部……说实话，对于萝莉体型的青蛙来说是不可能的吧」
「さぁさぁ、遠慮せずにたっぷり出すがいい	「来、不用客气、尽情地发挥吧
「んっくぅうう～～～～……はぁ、はぁぁんっ	「去惹哦哦哦哦～～～～……哈啊、哈啊啊啊
「ふっ…ふふ…こっちの穴も、いいもんだな…あッ	「呼…呵呵…这里的小穴也、挺不错的呢…啊
「くぶッ…んんむぅぅッ	「咕噗…嗯姆嗯姆
レロォ……」	嘞咯……」
「調(みつぎ)はこれだけか？もっと出るだろう…神の粥だよっ	「贡品就只有这些吗？应该还有更多吧……这可是献给神的白粥啊
「んっぶっ…んむぐぅッ！……げふォッ　えほォッ！……おえぇぇッ…」	「嗯噗……嗯咕姆！……呃噗 呃呼！……呕呕呕呃哇……」
「ばか者！出す前に言わないか！……えぐっ……少し気管に入ったわ……」	「笨蛋！出来前不先说一声吗！……呃咕……有点呛进气管里了……」
「ふふふ、どうだ軍神の手は……戦ばかりでガサガサだけどねぇ……」	「呵呵呵、军神的手怎么样……虽然因为一直战斗搞得有点粗糙就是了……」
「これで握ると……ほら	「这样握住……看
はははっ！堪え性ないじゃないかっ！」	哈哈哈！真是个没耐性的人啊！」
「私に手コキをさせるとは大した度胸じゃないの」	「敢让吾来给你手交、还真是大胆呢
「いいだろう、枯れるまで付き合ってやる……」	「好吧、我会陪你到你精疲力尽为止……」
